Date,Address,Location,Area,ExtraArea,TotalArea,Rooms,LandArea,Price
2017-11-23,Sjöhåla 580,"Kovikshamn, Kungälvs kommun",94,87,181,5,1068,3100000
2017-11-18,Galeasgatan 15,"Kungälv, Kungälvs kommun",103,64,167,5,610,3850000
2017-11-15,Rishammarvägen 17,"Kareby, Kungälvs kommun",120,80,200,6,1142,4375000
2017-11-10,Nygatan 14,"Marstrand - Koön, Kungälvs kommun",167,80,247,6,677,10800000
2017-11-01,Kodevägen 3,"KODE, Kungälvs kommun",150,50,200,7,2025,4300000
2017-10-27,Staby 350,"Kärna, Kungälvs kommun",110,80,190,4,911,2425000
2017-10-23,Östra Gatan 9,"Centrum, Kungälvs kommun",325,82,407,10,359,7900000
2017-10-20,Fredkullagatan 8,"Komarken, Kungälvs kommun",175,100,275,6,741,7160000
2017-10-16,Mjölnarvägen 13,"Diseröd, Kungälvs kommun",158,59,217,7,899,3965000
2017-10-13,Kulperödsvägen 5A,"Gullbringa, Kungälvs kommun",100,20,120,5,450,2495000
2017-10-13,Stora Ryr 130,"Lycke, Kungälvs kommun",80,20,100,5,2270,1600000
2017-10-12,Röd 140,"Kareby, Kungälvs kommun",122,11,133,4,2052,3400000
2017-10-05,Kärnavägen 4,"Kärna, Kungälvs kommun",110,90,200,7,860,4100000
2017-10-05,Enekullsvägen 28,"Enekullen, Kungälvs kommun",125,18,143,4,789,4100000
2017-10-03,Skårshöjd 8,"Kärna, Kungälvs kommun",120,40,160,5,900,2700000
2017-09-21,Bergåsvägen 23,"Ytterby, Kungälvs kommun",131,37,168,5,1267,4575000
2017-09-20,Vävra 710,"Hålta, Kungälvs kommun",100,100,200,5,4794,3650000
2017-09-20,Trätäljagatan 2,"Iskällan, Kungälvs kommun",147,147,294,9,937,5875000
2017-09-10,Torp 340,"Kareby, Kungälvs kommun",127,100,227,6,21023,4325000
2017-09-08,Västra Åkerhögsvägen 17,"Kärna, Kungälvs kommun",155,20,175,6,1824,4575000
2017-09-07,Rävo 170,"Hålta, Kungälvs kommun",165,60,225,5,4627,7150000
2017-09-05,Snäckliden 13,"Sundhammar, Kungälvs kommun",48,33,81,4,1590,2800000
2017-08-31,Sjöhåla 170,"KÄRNA, Kungälvs kommun",124,72,196,5,2035,3550000
2016-10-08,Solvagnsgatan 28,"Ytterby - Stället, Kungälvs kommun",164,12,176,6,441,4725000
2016-10-05,Sköldgatan 5,"Ytterby Stället, Kungälvs kommun",137,8,145,5,437,4400000
2016-09-29,Lökebergsvägen 41,"Lökeberg, Kungälvs kommun",44,6,50,2,1511,2550000
2016-09-29,Domsvägen 3,"Ytterby, Kungälvs kommun",157,99,256,6,921,4850000
2016-09-13,Kastellegårdsgatan 47,"KUNGÄLV, Kungälvs kommun",116,50,166,4,938,3425000
2016-09-09,Annas väg 25,"Kovikshamn, Kungälvs kommun",62,22,84,3,1026,2730000
2016-09-02,Knaverstad-Ryr 580,"Aröd, Kungälvs kommun",158,4,162,6,1012,2840000
2016-09-01,Solrosvägen 12,"Kärna, Kungälvs kommun",135,96,231,8,818,3325000
2016-08-26,Skårby Mosse 870,"Bohuslän, Kungälvs kommun",147,50,197,5,3073,4000000
2016-08-25,Rörtången 126,"Rörtången, Kungälvs kommun",170,20,190,5,1638,8700000
2016-08-20,Tegskiftegatan 20,"YTTERBY, Kungälvs kommun",102,102,204,5,969,3550000
2016-08-18,Bärtas väg 23,"Ödsmålsmosse, Kungälvs kommun",51,20,71,3,1380,3025000
2016-08-15,Långgatan 8,"Marstrandsön, Kungälvs kommun",244,50,294,11,318,11250000
2016-08-12,Åsebyberg 847,"KODE, Kungälvs kommun",120,15,135,4,1163,3300000
2016-07-28,Tröskvägen 256,"Ullstorp, Kungälvs kommun",149,9,158,6,440,5355000
2016-07-25,Stenstavägen 21,"Tjuvkil, Kungälvs kommun",140,58,198,6,1223,6000000
2016-07-20,Rombacka 180,"Kareby, Kungälvs kommun",53,7,60,2,2031,1075000
2016-07-18,Vedbackavägen 4 A + B,"Rödbo, Kungälvs kommun",254,42,296,7,1046,2900000
2016-07-15,Gunneröd 290,"Lycke, Kungälvs kommun",132,39,171,4,2125,2300000
2016-07-13,Duvesjön 228,"Duvesjön, Kungälvs kommun",121,37,158,5,1150,3400000
2016-07-11,Violgatan 7,"Ytterby, Kungälvs kommun",139,36,175,7,588,4200000
2016-07-08,Rörtången 103,"Rörtången, Kungälvs kommun",162,62,224,5,1015,7250000
2016-07-06,Nereby 360,"Kärna - Harestad, Kungälvs kommun",120,40,160,6,1149,3100000
2016-07-05,Mariebergsvägen 130,"Östra Kungälv - Marieberg, Kungälvs kommun",230,41,271,10,2100,5520000
2016-07-05,Lerlycke 240,"Lerlycke - Kärna, Kungälvs kommun",129,44,173,3,12665,4420000
2016-07-04,Rörtången 295,"Kode, Kungälvs kommun",90,15,105,4,1795,5275000
2016-06-28,Rörmossevägen 180,"Rörmossen, Kungälvs kommun",110,135,245,6,1827,3725000
2021-04-20,Gulskärsvägen 21,"Tjuvkil, Kungälvs kommun",149,14,163,6,1512,7400000
2021-04-20,Mårdgatan 4,"Olseröd, Kungälvs kommun",124,45,169,5,1122,7150000
2021-04-16,Lindvägen 8,"Ytterby, Kungälvs kommun",244,72,316,7,1330,7700000
2021-04-15,Duvesjön 228,"Diseröd, Kungälvs kommun",121,37,158,5,1150,4925000
2021-04-15,Kuskalundsvägen 11,"Hålta, Kungälvs kommun",110,49,159,3,1227,4025000
2021-04-14,Ulvesund 412,"Ulvesund, Kungälvs kommun",106,9,115,4,806,4750000
2021-04-13,Klintegatan 7,"Kungälv - Centrum, Kungälvs kommun",143,112,255,5,798,7750000
2021-04-08,Prästvägen 170,"Kareby, Kungälvs kommun",95,140,235,7,2868,3770000
2021-04-04,Hammarberg 825,"Kode, Kungälvs kommun",65,74,139,5,3030,4350000
2021-04-02,Duvesjön 420,"Bohuslän, Kungälvs kommun",127,10,137,5,834,5400000
2021-04-01,Rönnvägen 11,"Diseröd, Kungälvs kommun",120,88,208,6,849,3465000
2021-04-01,Toreby mosse 570,"Ytterby, Kungälvs kommun",110,80,190,8,1375,2980000
2021-04-01,Häljeröd 106,"Diseröd, Kungälvs kommun",120,90,210,8,1734,3700000
2021-03-26,Domsvägen 7B,"Centralt Ytterby, Kungälvs kommun",159,62,221,6,600,5500000
2021-03-23,Ekvägen 2,"Ytterby, Kungälvs kommun",177,60,237,7,769,7700000
2021-03-22,Råckeröd 140,"Kärna, Kungälvs kommun",66,20,86,3,2269,3800000
2021-03-18,Hallbjörtorp 492,"Kärna, Kungälvs kommun",104,8,112,3,1499,3900000
2021-03-18,Dösebacka 130,"Diseröd, Kungälvs kommun",123,41,164,6,4859,5350000
2021-03-17,Åsgatan 17A,"Centrum, Kungälvs kommun",84,44,128,4,903,5620000
2021-03-17,Tvetgatan 263,"Tveten, Kungälvs kommun",100,50,150,6,138,3850000
2021-03-16,Tjuvkil 450,"Tjuvkil, Kungälvs kommun",237,118,355,8,1434,3120000
2021-03-16,Rondan 19,"Rörtången / Ödsmålsmosse, Kungälvs kommun",60,60,120,4,1927,4400000
2021-03-16,Åsebyberg 960,"Kode, Kungälvs kommun",157,16,173,5,1038,3850000
2021-03-16,Ulvegärdegatan 15,"Ulvegärde, Kungälvs kommun",140,96,236,7,1438,6100000
2021-03-12,Flateby 480,"Harestad, Kungälvs kommun",59,16,75,3,1194,1600000
2021-03-10,Älvängen 130,"Harestad, Kungälvs kommun",317,71,388,10,1180,5250000
2021-03-03,Tegskiftegatan 46,"Ytterby, Kungälvs kommun",184,54,238,8,865,6850000
2021-02-27,Granliden 11,"Vedhall, Kungälvs kommun",253,23,276,5,578,9200000
2021-02-22,Annas väg 4,"Kärna, Kungälvs kommun",102,7,109,4,1158,3700000
2021-02-18,Madängsgatan 13,"Centrum, Kungälvs kommun",154,18,172,7,740,5750000
2021-02-15,Bokvägen 12,"Fontin, Kungälvs kommun",175,35,210,6,635,7400000
2022-01-25,Långåkersgatan 6,"Centralt, Kungälvs kommun",140,36,176,5,733,7000000
2022-01-21,Skvaltvägen 3,"Diseröd, Kungälvs kommun",180,145,325,8,1352,5975000
2022-01-19,Trätäljagatan 7,"Iskällan, Kungälvs kommun",142,142,284,7,1037,7550000
2022-01-18,Hemvägen 21,"Diseröd, Kungälvs kommun",108,32,140,4,384,4050000
2022-01-11,Ödsmål 540,"Rörtången, Kungälvs kommun",65,31,96,4,916,3850000
2022-01-07,Mariebergsliden 5,"Öster, Kungälvs kommun",277,91,368,7,589,10000000
2021-12-30,Älvängen 180,"Harestad, Kungälvs kommun",75,58,133,4,1631,4150000
2021-12-08,Stora Ryr 310,"Tjuvkil/ Lycke, Kungälvs kommun",106,55,161,5,1239,3695000
2021-12-07,Mårdgatan 11,"Klöverbacken - Olseröd, Kungälvs kommun",166,12,178,5,367,6310000
2021-12-06,Ulvebackegatan 3,"Ulvegärde, Kungälvs kommun",129,44,173,4,927,4600000
2021-12-03,Plogvägen 187,"Ullstorp, Kungälvs kommun",122,6,128,5,406,5600000
2021-12-03,Galärgatan 1,"Centralt vid älven, Kungälvs kommun",104,4,108,4,762,3900000
2021-12-01,Korpedalsvägen 13,"Aröd/Timmervik, Kungälvs kommun",47,40,87,2,1179,2850000
2021-11-28,Fontinvägen 13,"Bohuslän, Kungälvs kommun",120,110,230,4,1167,6960500
2021-11-26,Kyrkeby 300,"Harestad, Kungälvs kommun",114,117,231,6,1402,4170000
2021-11-25,Parkgatan 21,"Marstrand - Koön, Kungälvs kommun",113,76,189,7,592,6100000
2021-11-25,Bäckgatan 38,"Centrum, Kungälvs kommun",108,60,168,7,607,6670000
2021-11-17,Nygatan 36,"Marstrand, Kungälvs kommun",118,30,148,4,146,5900000
2021-11-17,Hammarberg 840,"Kode, Kungälvs kommun",82,14,96,3,1893,3420000
2021-11-15,Vallgatan 3,"Kungälv - Centralt, Kungälvs kommun",65,61,126,5,495,5800000
2021-11-03,Grindklykan 7,"Grinden, Kungälvs kommun",114,7,121,4,392,5095000
2021-10-30,Granliden 9,"Vedhall, Kungälvs kommun",181,25,206,5,678,9550000
2021-10-28,Östra gatan 43,"Bohuslän, Kungälvs kommun",134,31,165,5,1403,5600000
2021-10-27,Hamngatan 1,"Centralt vid älven, Kungälvs kommun",136,83,219,6,617,6010000
2022-04-24,Granvägen 7,"Ytterby, Kungälvs kommun",100,54,154,4,623,5300000
2022-04-14,Marieberg 210,"Kungälv, Kungälvs kommun",120,34,154,5,3245,3150000
2022-04-14,Dotorp 260,"Kungälv - Kärna, Kungälvs kommun",162,9,171,6,2003,4775000
2022-04-13,Högalidsgatan 12,"Centralt vid älven, Kungälvs kommun",139,72,211,7,816,6450000
2022-04-13,Kodevägen 15,"Kode, Kungälvs kommun",147,123,270,6,1301,4525000
2022-04-04,Kärnavägen 7,"Kärna, Kungälvs kommun",97,133,230,7,786,3995000
2022-04-03,Åsebyberg 735,"Kode, Kungälvs kommun",158,21,179,5,1362,6200000
2022-03-30,Lagvägen 4,"Ytterby, Kungälvs kommun",129,20,149,5,816,5630000
2022-03-25,Åsebyberg 755,"Kode, Kungälvs kommun",75,40,115,3,961,3900000
2022-03-25,Västra Strandgatan 3,"Centralt vid älven, Kungälvs kommun",111,61,172,5,650,6000000
2022-03-17,Matskärsvägen 6,"Tjuvkil, Kungälvs kommun",155,19,174,7,521,6300000
2022-03-15,Hallsbergsvägen 12,"Kode, Kungälvs kommun",150,15,165,6,1639,5800000
2022-03-11,Rönnvägen 22,"Romelanda, Kungälvs kommun",108,70,178,6,823,5000000
2022-03-10,Galärgatan 8,"Centrum, Kungälvs kommun",119,62,181,5,655,4700000
2022-03-10,Bergkristallvägen 3,"Kode, Kungälvs kommun",125,9,134,5,527,5460000
2022-03-09,Dammen 135,"Kode, Kungälvs kommun",90,20,110,4,4698,3200000
2022-03-09,Rondan 19,"Ödsmålsmosse, Kungälvs kommun",60,60,120,4,1927,5400000
2022-03-09,Tvetgatan 289,"Bohuslän, Kungälvs kommun",130,9,139,5,127,4440000
2022-03-03,Östergårdsgatan 20,"Ytterby, Kungälvs kommun",133,65,198,6,1154,5720000
2022-03-03,Ivar Claessons gata 10,"Kungälv - Centralt, Kungälvs kommun",105,53,158,5,967,5300000
2022-02-24,Häljeröd 170,"Romelanda, Kungälvs kommun",102,48,150,4,13432,5750000
2022-02-21,Hallsbergsvägen 7,"Kode, Kungälvs kommun",172,85,257,7,3363,5450000
2022-02-19,Grandalen 200,"Romelanda, Kungälvs kommun",115,21,136,4,1937,4290000
2022-02-18,Fontinvägen 23,"Centralt, Kungälvs kommun",168,75,243,6,1402,5900000
2022-02-17,Lefstadvägen 35,"Kärna, Kungälvs kommun",127,61,188,5,1255,5700000
2022-02-09,Signehög 360,"Bohuslän, Kungälvs kommun",78,68,146,4,2771,3825000
2022-02-03,Sundhammarsvägen 480,"Kovikshamn/Sundhammar, Kungälvs kommun",167,13,180,5,2290,6475000
2022-01-28,Gamla Kungälvsvägen 9,"Ytterby, Kungälvs kommun",65,88,153,4,1000,5555000
2021-06-08,Flateby 360,"Kungälv - Harestad, Kungälvs kommun",125,95,220,7,1726,3100000
2021-06-04,Lievägen 237,"Ullstorp, Kungälvs kommun",140,19,159,5,507,6200000
2021-06-03,Skårby station 550,"Kungälv - Kareby, Kungälvs kommun",96,90,186,6,1087,3450000
2021-06-02,Skårshöjd 8,"Kärna, Kungälvs kommun",140,40,180,5,921,4425000
2021-06-02,Ametistvägen 5,"Kode, Kungälvs kommun",98,95,193,5,780,4900000
2021-05-28,Signehög 150,"Romelanda, Kungälvs kommun",130,130,260,6,2151,2200000
2021-05-25,Hamngatan 13,"Centralt vid älven, Kungälvs kommun",64,60,124,4,645,4900000
2021-05-25,Guddeby 274,"Ytterby, Kungälvs kommun",159,55,214,7,1527,6500000
2021-05-19,Parkgatan 18,"Marstrand - Koön, Kungälvs kommun",160,30,190,6,562,9400000
2021-05-19,Lyckevägen 5B,"Kärna, Kungälvs kommun",95,61,156,3,673,4400000
2021-05-18,Stora Risby 480,"Hålta, Kungälvs kommun",108,26,134,5,941,4950000
2021-05-18,Grepvägen 385,"Ullstorp, Kungälvs kommun",121,29,150,5,388,5640000
2021-05-17,Fridhemsgatan 9,"Centralt, Kungälvs kommun",137,90,227,6,850,6525000
2021-05-17,Lökebergsvägen 43,"Lökeberg, Kungälvs kommun",120,54,174,4,3364,4825000
2021-05-16,Häljeröd 210,"Romelanda, Kungälvs kommun",160,35,195,4,1690,3550000
2021-05-14,Vegestorp 210,"Kareby, Kungälvs kommun",98,98,196,5,1610,4125000
2021-05-12,Olvonvägen 27,"Diseröd, Kungälvs kommun",123,97,220,6,682,5150000
2021-05-11,Storskiftegatan 55,"Ytterby, Kungälvs kommun",131,46,177,5,835,6550000
2021-05-10,Glose 630,"Kärna, Kungälvs kommun",96,17,113,3,1187,4150000
2021-05-10,Lerlycke 240,"Kärna, Kungälvs kommun",135,44,179,3,9078,6000000
2021-05-08,Bergkristallvägen 5,"Kode, Kungälvs kommun",126,9,135,5,477,5000000
2021-05-07,Hällristningsgatan 18,"Ytterby - Stället, Kungälvs kommun",103,9,112,4,281,4650000
2021-05-05,Hareslättsvägen 8,"Marstrand, Kungälvs kommun",188,30,218,6,676,8800000
2021-05-05,Prejelvägen 109,"Ullstorp, Kungälvs kommun",122,12,134,5,432,5640000
2021-04-29,Holm 220,"Bohuslän, Kungälvs kommun",175,93,268,7,479907,10000000
2021-04-29,Mycklaborgsgatan 3,"Centrum, Kungälvs kommun",149,20,169,5,684,5100000
2021-04-29,Östra gatan 34,"Bohuslän, Kungälvs kommun",208,49,257,8,2419,6000000
2021-04-26,Ulvebackegatan 20,"Ulvegärde, Kungälvs kommun",196,30,226,6,766,6500000
2021-04-25,Gårdskiftegatan 67,"Ytterby, Kungälvs kommun",103,34,137,4,780,5000000
2017-02-21,Mycklaborgsgatan 5,"Kungälv - Centralt, Kungälvs kommun",140,20,160,5,664,3900000
2017-02-18,Högsberg 320,"Kode, Kungälvs kommun",80,32,112,2,1114,2650000
2017-02-16,Hövdingagatan 1,"Centrum, Kungälvs kommun",163,160,323,6,1030,5400000
2017-02-16,Häljeröd 260,"Häljeröd, Kungälvs kommun",137,99,236,5,909,2600000
2017-02-15,Kuskalundsvägen 33,"Vävra, Kungälvs kommun",83,13,96,4,1519,3250000
2017-02-13,Toreby Mosse 600,"Kungälv - Harestad, Kungälvs kommun",104,16,120,4,1622,3750000
2017-02-08,Poppelvägen 4,"Kungälv - Romelanda, Kungälvs kommun",155,34,189,6,800,4000000
2017-02-07,Skårby Station 500,"Kungälv - Kareby, Kungälvs kommun",200,88,288,8,19677,6200000
2017-02-07,Staby 200,"KÄRNA, Kungälvs kommun",132,72,204,5,1032,2562000
2017-02-03,Guddeby 272,"Ytterby, Kungälvs kommun",168,37,205,5,1552,4700000
2017-01-26,Skårby Station 560,"Kareby, Kungälvs kommun",115,118,233,7,1269,3500000
2017-01-21,Hövdingagatan 5,"Kungälv - Centralt, Kungälvs kommun",170,34,204,6,641,4740000
2017-01-12,Hallsbergsvägen 6,"Kode, Kungälvs kommun",139,10,149,5,3353,3550000
2017-01-04,Hallbjörtorp 290,"Kärna, Kungälvs kommun",75,75,150,5,1312,3300000
2016-12-16,Skvaltvägen 3,"Romelanda Diseröd, Kungälvs kommun",180,145,325,8,1352,3700000
2016-12-09,Västerhöjdsvägen 8,"Kärna, Kungälvs kommun",81,43,124,6,473,3200000
2016-12-02,Östergårdsgatan 12,"Kungälv - Ytterby, Kungälvs kommun",180,55,235,5,1137,5460000
2016-11-29,Åseby 400,"Kungälv - Rörtången, Kungälvs kommun",154,5,159,5,2523,4550000
2016-11-22,Västra Gatan 35a,"Kungälv - Centrum, Kungälvs kommun",214,44,258,8,344,6450000
2016-11-17,Diserödsvägen 15,"Romelanda Diseröd, Kungälvs kommun",114,105,219,7,719,3825000
2016-11-12,Gunneröd 460,"LYCKE, Kungälvs kommun",87,45,132,3,1067,2725000
2016-11-04,Rökgatan 9,"Centrum, Kungälvs kommun",71,59,130,5,737,2950000
2016-11-01,Väderhattsgatan 3,"Iskällan, Kungälvs kommun",180,81,261,8,1069,6030000
2016-10-27,Skårpedal 160,"Lycke, Kungälvs kommun",122,70,192,5,1643,3530000
2016-10-26,Vävra 495,"Vävra - Tjuvkil - Kungälv, Kungälvs kommun",34,55,89,2,3273,950000
2016-10-20,Oxelvägen 40,"Romelanda, Kungälvs kommun",109,45,154,5,300,3460000
2016-10-18,Ulvebackegatan 6,"Bohuslän, Kungälvs kommun",135,28,163,5,1135,4400000
2016-10-17,Häljeröd 190,"Romelanda, Kungälvs kommun",84,79,163,5,4000,3400000
2016-10-13,Västerängen 17,"Ytterby, Kungälvs kommun",143,37,180,6,825,4550000
2016-10-12,Solhultsgatan 20,"Centrum, Kungälvs kommun",112,46,158,4,558,3830000
2018-04-05,Gategården 182,"Hålta, Kungälvs kommun",240,50,290,8,1484,4020000
2018-03-29,Hallebäcksvägen 2,"Timmervik, Kungälvs kommun",73,7,80,3,1029,2550000
2018-03-27,Snäckvägen 11,"Ödsmåls mosse/Rörtången, Kungälvs kommun",45,25,70,2,1593,2000000
2018-03-20,Rishammarvägen 32,"Kareby, Kungälvs kommun",122,61,183,5,794,4750000
2018-03-16,Svärdgatan 8,"Ytterby, Kungälvs kommun",137,8,145,5,428,5250000
2018-03-10,Dotorp 400,"Kärna, Kungälvs kommun",114,54,168,5,5650,4200000
2018-03-09,Skomakarevägen 17,"Hålta, Kungälvs kommun",178,24,202,6,2018,3730000
2018-03-07,Åldermansvägen 4,"Ytterby, Kungälvs kommun",130,125,255,7,695,4700000
2018-02-27,Jorsalagatan 1,"Iskällan, Kungälvs kommun",119,97,216,7,891,4300000
2018-02-26,Prästvägen 830,"Diseröd, Kungälvs kommun",259,48,307,10,3049,6250000
2018-02-23,Länsmansvägen 24,"Ytterby, Kungälvs kommun",126,85,211,4,915,4600000
2018-02-21,Rättarevägen 11,"Ytterby, Kungälvs kommun",105,122,227,6,477,4780000
2018-02-21,Västerhöjdsvägen 44,"Bohuslän, Kungälvs kommun",104,15,119,6,285,4250000
2018-02-08,Arntorp 190,"Kareby, Kungälvs kommun",85,92,177,4,1048,2735000
2018-02-03,Solskiftegatan 38,"Ytterby, Kungälvs kommun",110,50,160,5,797,4560000
2018-02-03,Torsbyvägen 22,"Ytterby, Kungälvs kommun",170,53,223,7,1650,4800000
2018-01-14,Kolonigatan 6,"Marstrand, Kungälvs kommun",135,75,210,5,863,8300000
2018-01-12,Signehög 210,"Romelanda, Kungälvs kommun",142,28,170,6,945,3350000
2018-01-03,Nordängen 2,"Sundhammar, Kungälvs kommun",165,7,172,6,1936,6500000
2018-01-02,Kristiansborg 350,"Tjuvkil, Kungälvs kommun",121,65,186,5,1099,5500000
2017-12-20,Ulvesund 530,"Ytterby - Ulvesund, Kungälvs kommun",75,20,95,4,3233,3045000
2017-12-13,Prejelvägen 117,"Ullstorp, Kungälvs kommun",122,8,130,5,596,4740000
2017-12-13,Krappvägen 571,"KUNGÄLV, Kungälvs kommun",148,10,158,5,382,6000000
2017-12-02,Lefstad 230,"Kärna, Kungälvs kommun",93,93,186,7,1603,3580000
2017-11-29,Prejelvägen 137,"Bohuslän, Kungälvs kommun",122,10,132,5,423,4850000
2017-11-27,Plogvägen 191,"Ullstorp, Kungälvs kommun",122,26,148,5,402,4800000
2017-11-24,Västra gatan 40,"Centralt, Kungälvs kommun",133,50,183,6,1096,6350000
2013-05-24,Gårdskiftegatan 41,"Ytterby-Tega, Kungälvs kommun",174,14,188,6,735,3075000
2013-05-24,Kuskalundsvägen 36,"Vävra, Kungälvs kommun",120,45,165,6,1339,1850000
2013-05-16,Grokareby 150,"Kareby, Kungälvs kommun",123,45,168,4,2081,2620000
2013-04-30,Staby 490,"Kärna, Kungälvs kommun",92,60,152,4,2230,2500000
2013-04-30,Skeppsholmsgatan 3,"Centralt, Kungälvs kommun",95,3,98,4,780,3200000
2013-04-30,Flateby 500,"Kärna - Harestad, Kungälvs kommun",110,68,178,6,4215,2610000
2013-04-21,Stenåldersgatan 4,"Ytterby - Stället, Kungälvs kommun",107,5,112,5,459,2775000
2013-04-18,Ulvesund 419,"Ytterby, Kungälvs kommun",65,15,80,3,688,2150000
2013-04-17,Östra Trädal 360,"Ytterby - Östra Trädal, Kungälvs kommun",160,80,240,7,11627,3400000
2013-04-10,Ringby 164,"Kareby, Kungälvs kommun",128,32,160,4,1300,3250000
2013-04-08,Jorsalagatan 5,"Iskällan, Kungälvs kommun",185,36,221,6,860,4100000
2013-03-21,Egnahemsgatan 10,"Centralt, Kungälvs kommun",65,65,130,3,446,2825000
2013-03-08,Bokstigen 4,"Centralt, Kungälvs kommun",140,50,190,5,1661,3330000
2020-03-30,Lyckan 2,"Komarken, Kungälvs kommun",111,60,171,7,861,3630000
2020-03-27,Löstorp 160,"Kareby, Kungälvs kommun",62,24,86,3,1282,2850000
2020-03-23,Rishammarvägen 11,"Kareby, Kungälvs kommun",115,28,143,6,2862,5525000
2020-03-11,Alvägen 1,"Diseröd, Kungälvs kommun",126,43,169,6,668,3795000
2020-03-09,Byvägen 50,"Ödsmålsmosse, Kungälvs kommun",163,52,215,5,1275,4400000
2020-03-06,Skårsäng 25,"Kärna, Kungälvs kommun",147,9,156,6,547,4650000
2020-03-05,Häljeröd 380,"Diseröd, Kungälvs kommun",140,190,330,7,3521,4425000
2020-03-03,Tjuvkil 140,"Tjuvkil, Kungälvs kommun",80,12,92,3,2819,2900000
2020-03-02,Fontinvägen 32,"Kungälv Centralt, Kungälvs kommun",160,50,210,7,811,6300000
2020-03-02,Duvesjön 327,"Kungälv -Duvesjön, Kungälvs kommun",103,24,127,4,1320,3900000
2020-02-27,Ivar Claessons gata 8,"Kungälv, Kungälvs kommun",121,30,151,6,1103,5500000
2020-02-26,Storskiftegatan 71,"Övre Tega, Kungälvs kommun",129,28,157,5,798,5600000
2020-02-26,Krappvägen 556,"Bohuslän, Kungälvs kommun",174,40,214,6,783,7925000
2020-02-21,Brunnefjällsvägen 26,"Kärna, Kungälvs kommun",79,5,84,3,1157,2360000
2020-02-19,Reidarsgatan 3,"Centralt vid älven, Kungälvs kommun",150,28,178,5,686,5350000
2020-02-19,Lefstadvägen 27,"Kärna, Kungälvs kommun",113,21,134,3,1351,4090000
2020-02-07,Rishammar 110,"Kareby, Kungälvs kommun",140,19,159,6,1205,4135000
2020-02-03,Mariebergsvägen 150,"Kungälv, Kungälvs kommun",173,86,259,8,4083,4250000
2020-02-02,Åsebyberg 940,"Kode, Kungälvs kommun",138,30,168,5,57649,4400000
2020-01-30,Jägarvägen 5,"Diseröd, Kungälvs kommun",168,8,176,7,550,3795000
2020-01-28,Staby 780,"Kärna, Kungälvs kommun",108,50,158,4,2026,3050000
2020-01-28,Toreby mosse 600,"Harestad och Kärna, Kungälvs kommun",104,16,120,4,1622,3900000
2020-01-28,Hemvägen 19,"Romelanda, Kungälvs kommun",119,19,138,5,381,2900000
2020-01-22,Gårdskiftegatan 72,"Ytterby, Kungälvs kommun",105,109,214,6,856,5050000
2020-01-21,Duvesjön 201,"Bohuslän, Kungälvs kommun",38,9,47,2,1390,1880000
2023-10-09,Skårby station 350,"Kareby, Kungälvs kommun",143,25,168,7,2303,3005000
2023-10-05,Högalidsgatan 3,"Centrum, Kungälvs kommun",103,103,206,5,862,3800000
2023-10-03,Kungälvsvägen 22,"Centralt, Kungälvs kommun",77,46,123,5,1548,4500000
2023-09-22,Heavägen 31,"Lycke, Kungälvs kommun",165,30,195,6,1553,5450000
2023-09-17,Kornhall 290,"Kornhall, Kungälvs kommun",134,7,141,5,1706,6100000
2023-09-13,Kristiansborg 300,"Bohuslän, Kungälvs kommun",215,115,330,5,3121,5350000
2023-09-07,Glöskär 255,"Kärna, Kungälvs kommun",111,22,133,4,2062,3520000
2023-08-29,Västra Röd 165,"Kärna, Kungälvs kommun",151,20,171,5,2263,5995000
2023-08-24,Snorregatan 3B,"Komarken, Kungälvs kommun",120,3,123,5,342,4225000
2023-08-23,Jägarvägen 13,"Romelanda, Kungälvs kommun",162,14,176,5,569,3900000
2023-08-16,Stora Lycke 400,"Bohuslän, Kungälvs kommun",111,5,116,5,761,3650000
2023-08-15,Dösebacka 410,"Romelanda, Kungälvs kommun",38,11,49,3,5960,2300000
2023-08-09,Mantalsgatan 9,"Tega, Kungälvs kommun",175,35,210,7,1105,4725000
2023-08-08,Skälebräckeliden 9,"Centrum, Kungälvs kommun",113,85,198,4,1608,6275000
2023-07-17,Duvesjön 228,"Romelanda, Kungälvs kommun",121,37,158,5,1150,4195000
2023-07-17,Klintegatan 22,"Centralt, Kungälvs kommun",119,55,174,5,999,6500000
2023-07-13,Galärgatan 2,"Kungälv Centrum, Kungälvs kommun",103,60,163,5,749,4300000
2023-07-13,Ulvebackegatan 3,"Munkegärde, Kungälvs kommun",129,44,173,5,927,4850000
2023-07-11,Vråstigen 4,"Överön, Kungälvs kommun",81,57,138,4,2619,3775000
2023-07-06,Kastellegårdsgatan 29,"Komarken, Kungälvs kommun",122,16,138,4,1033,5200000
2023-07-04,Sparråsvägen 140,"Kungälv - Ytterby, Kungälvs kommun",137,19,156,4,961,3850000
2023-07-04,Dammen 160,"Kärna, Kungälvs kommun",174,25,199,5,3234,3450000
2023-07-03,Tulpanvägen 15,"Kärna, Kungälvs kommun",105,140,245,4,914,3900000
2023-06-30,Gårdskiftegatan 5,"Ytterby, Kungälvs kommun",164,36,200,5,806,5250000
2023-06-30,Norrmannebo 270,"Romelanda, Kungälvs kommun, Kungälvs kommun",114,110,224,7,1400,4300000
2023-06-29,Dösebacka 120,"Romelanda, Kungälvs kommun",64,53,117,3,3824,2960000
2023-06-28,Kärnavägen 16,"Kärna, Kungälvs kommun",171,83,254,7,695,4300000
2023-06-22,Torp 250,"Kareby, Kungälvs kommun",159,48,207,4,1608,3950000
2023-06-21,Korpvägen 279,"Ullstorp, Kungälvs kommun",133,24,157,4,522,5850000
2019-06-03,Svartbrödragatan 6,"Komarken, Kungälvs kommun",124,70,194,5,1086,5035000
2019-06-03,Norgårdsvägen 7,"Tjuvkil, Kungälvs kommun",102,57,159,4,808,3200000
2019-05-30,Kareby kyrkväg 220,"Bohuslän, Kungälvs kommun",131,95,226,6,1498,4275000
2019-05-28,Knapegården 126,"Bohuslän, Kungälvs kommun",143,40,183,6,3842,4900000
2019-05-27,Vallby 110,"Solberga-Kode, Kungälvs kommun",127,14,141,5,12135,5050000
2019-05-24,Munkegärdegatan 309,"Munkegärde, Kungälvs kommun",118,16,134,4,440,4135000
2019-05-17,Solskiftegatan 33,"Ytterby, Kungälvs kommun",166,47,213,6,773,4600000
2019-05-16,Aspvägen 3,"Ytterby, Kungälvs kommun",144,92,236,7,1561,5610000
2019-05-14,Kareby kyrkväg 260,"Kareby, Kungälvs kommun",170,58,228,5,2934,3300000
2019-05-14,Halltorpsvägen 9,"Kode, Kungälvs kommun",96,70,166,5,1293,3800000
2019-05-13,Akvamarinvägen 6,"Kode, Kungälvs kommun",98,95,193,5,780,3000000
2019-05-13,Norra Arödsvägen 12,"Bohuslän, Kungälvs kommun",100,24,124,3,1883,3100000
2019-05-12,Storskiftegatan 67,"Ytterby, Kungälvs kommun",117,49,166,5,921,5130000
2019-05-10,Tegskiftegatan 70,"Ytterby, Kungälvs kommun",117,117,234,7,1020,5140000
2019-05-10,Oskarsberg 130,"Kareby, Kungälvs kommun",135,16,151,4,2796,3300000
2019-05-09,Jägersberg 340,"Bohuslän, Kungälvs kommun",146,30,176,5,29613,5750000
2019-05-08,Kristinedalsgatan 5,"Bohuslän, Kungälvs kommun",137,67,204,5,701,6700000
2019-05-04,Ragnhildsgatan 2,"Centralt, Kungälvs kommun",115,53,168,5,775,4100000
2019-04-26,Kristinedalsgatan 3,"Centrum, Kungälvs kommun",87,82,169,5,1231,5500000
2019-04-24,Broberg 120,"Tjuvkil, Kungälvs kommun",85,18,103,3,2064,3075000
2019-04-19,Häljeröd 400,"Romelanda, Kungälvs kommun",89,89,178,4,1181,2935000
2019-04-17,Tolleröd 160,"Kode, Kungälvs kommun",104,48,152,5,1582,3400000
2019-04-15,Bokvägen 11,"Fontin, Kungälvs kommun",112,17,129,5,600,5325000
2019-04-14,Kuskalundsvägen 5,"Hålta, Kungälvs kommun",75,20,95,3,1776,2800000
2019-04-12,Munkholmsgatan 5,"Kungälv, Kungälvs kommun",117,50,167,4,759,4550000
2014-12-03,Skälebräckeliden 8,"Kungälv - Centrum, Kungälvs kommun",125,85,210,8,1055,4250000
2014-11-28,Ängsgatan 19,"Centralt, Kungälvs kommun",145,62,207,9,626,3160000
2014-11-21,Kullegatan 10,"Centralt, Kungälvs kommun",113,51,164,7,543,3275000
2014-11-20,Nolby 170,"Kode, Kungälvs kommun",203,55,258,6,7383,4100000
2014-11-17,Kulperödsvägen 10,"Kungälv - Hålta, Kungälvs kommun",175,14,189,6,2341,3850000
2014-11-16,Häljeröd 300,"Kungälv - Romelanda, Kungälvs kommun",223,25,248,7,5647,5000000
2014-11-14,Rondan 8,"Ödsmålsmosse, Kungälvs kommun",125,29,154,5,1106,2920000
2014-11-12,Älvliden 2,"Kungälv, Kungälvs kommun",118,50,168,5,405,3450000
2014-11-12,Östergårdsgatan 23,"Ytterby, Kungälvs kommun",180,48,228,6,840,3500000
2014-11-09,Duvesjön 217,"Duvesjön / Kungälv, Kungälvs kommun",120,36,156,4,1091,3030000
2014-10-31,Dotorp 230,"Kärna, Kungälvs kommun",64,42,106,3,986,1800000
2014-10-28,Munkegärdegatan 251,"Kungälv, Kungälvs kommun",178,109,287,8,849,4325000
2014-10-15,Snäckvägen 3,"Ödsmålsmosse, Kungälvs kommun",76,28,104,4,1213,2575000
2014-10-13,Tulpanvägen 1,"Kärna, Kungälvs kommun",127,105,232,7,568,2225000
2014-10-09,Tegskiftegatan 50,"Tega, Kungälvs kommun",112,57,169,5,856,3150000
2014-09-26,Idrottsgatan 26,"Marstrand, Koön, Kungälvs kommun",130,20,150,5,565,4075000
2014-09-25,Västra Röd 130,"Kärna - Harestad, Kungälvs kommun",136,15,151,4,1170,3100000
2014-09-25,Skår 170,"Kärna, Kungälvs kommun",90,101,191,6,1054,2500000
2014-09-10,Hjälmgatan 1,"Ytterby - Stället, Kungälvs kommun",96,8,104,3,444,2900000
2014-09-09,Långåkersgatan 11,"Kungälv Centralt, Kungälvs kommun",129,36,165,5,1136,4700000
2014-09-08,Gamla Torget 10,"Kungälv Gamla Staden, Kungälvs kommun",90,23,113,4,134,3200000
2014-09-02,Norrmannebo 680,"Romelanda, Kungälvs kommun",172,71,243,7,4202,1700000
2014-08-26,Västerhöjdsvägen 18,"Kärna, Kungälvs kommun",115,3,118,4,291,3100000
2014-08-22,Gategården 182,"Hålta, Kungälvs kommun",240,50,290,8,1484,2975000
2014-08-20,Västra Porten 28,"Ytterby, Kungälvs kommun",120,16,136,3,954,3485000
2014-08-13,Rondan 22,"Ödsmålsmosse, Kungälvs kommun",72,65,137,6,1258,1900000
2014-06-30,Hasselvägen 4,"Romelanda - Diseröd, Kungälvs kommun",125,125,250,9,805,2300000
2014-06-25,Vävra 542,"Hålta, Kungälvs kommun",109,15,124,5,1106,2750000
2014-06-19,Halleravägen 8B,"Kovikshamn, Kungälvs kommun",150,30,180,7,3419,6050000
2014-06-18,Häljeröd 190,"Romelanda, Kungälvs kommun",84,79,163,5,7965,2710000
2015-04-09,Kristinedalsgatan 15,"Centralt, Kungälvs kommun",145,80,225,6,1191,4300000
2015-03-31,Sköldgatan 6,"Ytterby - Stället, Kungälvs kommun",96,8,104,3,402,3020000
2015-03-27,Solvagnsgatan 10,"Stället, Kungälvs kommun",139,12,151,5,405,4140000
2015-03-25,Tröskvägen 272,"Ullstorp, Kungälvs kommun",148,10,158,7,678,4870000
2015-03-25,Apelvägen 13,"Romelanda, Kungälvs kommun",106,4,110,6,449,2850000
2015-03-24,Prästvägen 715,"Romelanda, Kungälvs kommun",122,122,244,4,1025,3400000
2015-03-24,Kovikshamn 200,"Kungälv - Kovikshamn, Kungälvs kommun",90,85,175,3,1361,3500000
2015-03-24,Kulperödsvägen 11B,"Kungälv - Hålta, Kungälvs kommun",120,127,247,6,1007,5100000
2015-03-23,Hallebäcksvägen 2,"Kode, Kungälvs kommun",73,7,80,4,1029,1500000
2015-03-20,Flateby 590,"Harestad, Kungälvs kommun",114,65,179,3,3853,1995000
2015-03-20,Fågelstigen 36,"Kungälv, Kungälvs kommun",113,5,118,4,177,2980000
2015-03-19,Munkegärdegatan 320,"Munkegärde, Kungälvs kommun",148,36,184,7,675,4400000
2015-03-18,Norrmannebo 740 A,"Norrmannebo, Kungälvs kommun",84,9,93,5,931,1350000
2015-03-11,Norrmannebo 800,"Norrmannebo, Kungälvs kommun",150,10,160,6,2964,2600000
2015-03-05,Kulperödsvägen 17,"Bohuslän, Kungälvs kommun",133,119,252,6,2141,4200000
2015-03-03,Duvesjön 346,"Kungälv - Romelanda, Kungälvs kommun",145,7,152,6,900,3250000
2015-02-26,Fregattgatan 5,"Centralt, Kungälvs kommun",126,65,191,5,506,4300000
2015-02-26,Lilla Ryr 200,"Kungälv - Lycke, Kungälvs kommun",60,60,120,2,1406,2400000
2015-02-13,Bärnstensvägen 1,"Kode, Kungälvs kommun",177,170,347,7,1070,3050000
2015-02-12,Mellan-Restad 270,"Hålta, Kungälvs kommun",160,14,174,5,1233,3315000
2015-02-03,Tegskiftegatan 28,"Kungälv - Ytterby, Kungälvs kommun",134,134,268,7,832,4700000
2015-01-28,Grandalen 190,"Kungälv-Svartedalen, Kungälvs kommun",105,60,165,3,1378,1900000
2015-01-18,Vävra 120,"Bohuslän, Kungälvs kommun",121,25,146,7,3352,2600000
2015-01-16,Trankärrsliden 21,"Tveten & Skälebräcke, Kungälvs kommun",110,75,185,5,1216,2950000
2015-01-13,Lundby 475,"Kareby, Kungälvs kommun",141,40,181,5,2024,4000000
2014-12-12,Gårdskiftegatan 17,"Tega, Kungälvs kommun",163,35,198,6,1147,4050000
2019-08-20,Lysegården 110,"Romelanda, Kungälvs kommun",156,36,192,5,2899,3380000
2019-08-16,Munkholmsgatan 2,"Komarken, Kungälvs kommun",137,73,210,7,893,5400000
2019-08-16,Staby 360,"Kungälv - Kärna, Kungälvs kommun",119,75,194,5,1020,2900000
2019-08-16,Beryllvägen 2,"Kode, Kungälvs kommun",128,5,133,6,908,4455000
2019-08-15,Holm 440,"Kärna, Kungälvs kommun",131,13,144,5,1408,4275000
2019-08-12,Staby 750,"Kärna, Kungälvs kommun",117,151,268,7,2787,4325000
2019-08-02,Solvagnsgatan 2,"Ytterby, Kungälvs kommun",164,12,176,5,484,5455000
2019-08-01,Aspvägen 8,"Ytterby, Kungälvs kommun",130,90,220,5,602,4680000
2019-08-01,Rönnvägen 17,"Diseröd, Kungälvs kommun",125,80,205,6,805,3500000
2019-07-20,Prästvägen 990,"Diseröd, Kungälvs kommun",191,107,298,5,1941,5000000
2019-07-11,Bergliden 5,"Kode, Kungälvs kommun",68,16,84,3,1945,2970000
2019-07-09,Snäckliden 2,"Sundhammar, Kungälvs kommun",120,30,150,5,1085,4800000
2019-07-05,Vävra 470,"Hålta, Kungälvs kommun",160,10,170,5,3244,2900000
2019-07-05,Valeberg 105,"Solberga-Kode, Kungälvs kommun",98,55,153,4,2957,3350000
2019-07-03,Ranneberg 200,"Kärna, Kungälvs kommun",66,63,129,4,3315,2250000
2019-07-02,Vitsippegatan 12,"Ytterby, Kungälvs kommun",179,21,200,6,535,4650000
2019-06-28,Dotorp 250,"Kärna, Kungälvs kommun",126,32,158,5,1449,3825000
2019-06-26,Hövdingagatan 1,"Komarken, Kungälvs kommun",163,160,323,6,1030,5200000
2019-06-25,Ängsgatan 17,"Centralt, Kungälvs kommun",102,102,204,5,574,4620000
2019-06-23,Ranneberg 180,"Kärna, Kungälvs kommun",95,55,150,5,1204,2810000
2019-06-20,Enskiftegatan 14,"Ytterby, Kungälvs kommun",170,73,243,7,924,5575000
2019-06-20,Häljeröd 420,"Romelanda, Kungälvs kommun",146,62,208,5,1172,3800000
2019-06-20,Strömgatan 3,"Ytterby, Kungälvs kommun",94,47,141,5,955,4750000
2019-06-15,Norrmannebo 200,"Romelanda, Kungälvs kommun",127,71,198,6,3500,3200000
2019-06-14,Vråstigen 2,"Bohuslän, Kungälvs kommun",95,35,130,6,1661,3300000
2019-06-14,Skårby 590,"Kareby, Kungälvs kommun",65,10,75,2,1132,2350000
2019-06-11,Länsmansvägen 28,"Ytterby, Kungälvs kommun",127,51,178,6,862,4707000
2019-06-10,Nordön 180,"Tjuvkil, Kungälvs kommun",80,80,160,5,1587,4850000
2019-06-05,Brunskär 510,"Kärna, Kungälvs kommun",90,15,105,4,365,4250000
2020-05-20,Krokens väg 22,"Tjuvkil (västra delen)+Kroken, Kungälvs kommun",122,72,194,6,1320,5900000
2020-05-19,Bäckliden 10,"Kungälv, Kungälvs kommun",169,79,248,7,500,7700000
2020-05-16,Rishammarvägen 12,"Kungälv, Kungälvs kommun",185,26,211,7,747,6000000
2020-05-13,Kållen 140,"Romelanda, Kungälvs kommun",96,25,121,4,2207,3200000
2020-05-12,Kärnavägen 1,"Kärna, Kungälvs kommun",159,90,249,8,668,4300000
2020-05-12,Hamngatan 3,"Kungälv centralt, Kungälvs kommun",144,76,220,6,620,6100000
2020-05-12,Kvarnvägen 41,"Bohuslän, Kungälvs kommun",111,45,156,5,1194,3650000
2020-05-10,Åseby 120,"Kode / Solberga, Kungälvs kommun",91,71,162,3,19952,3825000
2020-05-06,Toftåsen 3,"Sundhammar, Kungälvs kommun",137,36,173,6,1235,5975000
2020-05-05,Skårshöjd 8,"Kärna, Kungälvs kommun",140,40,180,6,921,3700000
2020-04-29,Olserödsgatan 128,"Kungälv, Kungälvs kommun",150,39,189,4,1388,4650000
2020-04-28,Grokareby 130,"Kareby, Kungälvs kommun",200,26,226,6,6284,3825000
2020-04-28,Häljeröd 280,"Romelanda, Kungälvs kommun",199,24,223,7,3235,3700000
2020-04-25,Västra Röd 130,"Harestad, Kungälvs kommun",136,15,151,5,1170,4200000
2020-04-24,Bergåsvägen 17,"Ytterby, Kungälvs kommun",126,49,175,6,1054,4600000
2020-04-23,Aspvägen 7A,"Kungälv - Ytterby, Kungälvs kommun",106,104,210,6,640,4725000
2020-04-22,Hammar 150,"Harestad, Kungälvs kommun",95,65,160,4,1391,1895000
2020-04-22,Ingegatan 2E,"Komarken, Kungälvs kommun",102,49,151,5,108,3600000
2020-04-21,Tvetgatan 289,"Tveten, Kungälvs kommun",130,9,139,5,127,3700000
2020-04-17,Tjällviksvägen 14,"Instön, Kungälvs kommun",138,4,142,4,3032,4150000
2020-04-16,Ingetorp 190,"Kode, Kungälvs kommun",70,12,82,4,2160,2860000
2020-04-07,Bokvägen 8,"Centralt, Kungälvs kommun",170,40,210,8,635,6650000
2020-04-02,Löstorp 120,"Kareby, Kungälvs kommun",93,100,193,6,1313,3620000
2020-04-02,Flädervägen 48,"Diseröd, Kungälvs kommun",182,10,192,7,823,5455000
2020-04-02,Lievägen 232,"Ullstorp, Kungälvs kommun",134,5,139,5,257,5420000
2020-04-01,Lilla Fjellsholmen 33,"Lilla Fjellsholmen, Kungälvs kommun",108,18,126,4,412,7900000
2013-11-29,Rishammar 260,"Bohuslän, Kungälvs kommun",154,86,240,7,2982,2525000
2013-11-29,Skurhagagatan 4,"Centralt, Kungälvs kommun",190,75,265,7,798,2750000
2013-11-27,Domsvägen 4,"Ytterby, Kungälvs kommun",98,77,175,5,858,2150000
2013-11-25,Åldermansvägen 9,"Ytterby, Kungälvs kommun",174,74,248,5,1119,3600000
2013-11-15,Thorilds Gränd 9,"Centralt, Kungälvs kommun",121,3,124,4,422,4610000
2013-11-13,Åldermansvägen 12,"Ytterby, Kungälvs kommun",124,124,248,5,909,3745000
2013-11-11,Oskarsbergsgatan 34,"Tega, Kungälvs kommun",119,48,167,4,773,3020000
2013-11-04,Fontinvägen 26,"Centralt, Kungälvs kommun",166,63,229,6,1083,4675000
2013-10-31,Jägarvägen 6,"Bohuslän, Kungälvs kommun",159,16,175,5,564,2200000
2013-10-25,Komministergatan 16,"Centralt, Kungälvs kommun",175,100,275,7,723,5100000
2013-10-22,Fredkullagatan 24,"Centralt, Kungälvs kommun",80,40,120,4,918,2440000
2013-10-11,Åsleröd 110,"Ytterby, Kungälvs kommun",57,57,114,3,975,1555000
2013-10-11,Rundsvallen 150,"Ytterby - Rundsvallen, Kungälvs kommun",142,15,157,5,1440,2850000
2013-10-11,Krappvägen 574,"Ullstorp, Kungälvs kommun",170,29,199,5,807,4845000
2013-10-08,Glose 590,"Glose, Kungälvs kommun",108,57,165,5,1799,1850000
2013-10-08,Svärdgatan 6,"Stället, Kungälvs kommun",137,8,145,5,392,3560000
2013-10-03,Drakegatan 8,"Centralt, Kungälvs kommun",121,39,160,4,853,3400000
2013-09-18,Hällevad 140,"Duvesjön, Kungälvs kommun",144,58,202,6,2077,2955000
2013-09-13,Holm 230,"Kärna, Kungälvs kommun",155,7,162,6,2861,3700000
2013-09-09,Braseröd 120,"Romelanda, Kungälvs kommun",108,8,116,4,7164,1895000
2013-08-30,Lahälla 760,"Lahälla, Kungälvs kommun",181,60,241,5,2559,4500000
2013-08-30,Olsegården 13,"Olseröd, Kungälvs kommun",140,32,172,5,375,3280000
2013-08-28,Heden 180,"Ytterby-Ulvesund, Kungälvs kommun",60,57,117,3,2279,2500000
2013-08-26,Rönnvägen 14,"Romelanda - Diseröd, Kungälvs kommun",109,109,218,6,1059,2710000
2013-08-20,Ängsgatan 13,"Centralt, Kungälvs kommun",111,92,203,4,564,2550000
2013-08-15,Strandgatan 10B,"Centralt, Kungälvs kommun",101,6,107,4,414,3230000
2013-08-13,Vävra 705,"Hålta, Kungälvs kommun",118,11,129,4,1206,2450000
2013-08-05,Rönnvägen 1,"Romelanda - Diseröd, Kungälvs kommun",98,71,169,5,941,2250000
2013-07-22,Slånvägen 5,"Kärna, Kungälvs kommun",207,209,416,9,2017,3550000
2013-06-13,Karantänsgatan 4,"Bohuslän, Kungälvs kommun",145,70,215,7,619,4000000
2013-06-09,Rörtången 123,"Rörtången, Kungälvs kommun",101,70,171,3,1010,3600000
2023-03-23,Kulperödsvägen 17,"Bohuslän, Kungälvs kommun",133,119,252,6,2141,4800000
2023-03-09,Sköldgatan 8,"Stället, Kungälvs kommun",96,29,125,3,451,4225000
2023-03-08,Önneröd 120,"Kärna, Kungälvs kommun",133,29,162,5,3061,3750000
2023-03-02,Lagvägen 23,"Ytterby, Kungälvs kommun",107,7,114,4,757,2700000
2023-02-27,Tegskiftegatan 84,"Ytterby, Kungälvs kommun",101,146,247,5,1186,5310000
2023-02-21,Signehög 320,"Romelanda, Kungälvs kommun",105,57,162,5,1550,4350000
2023-02-07,Kärnavägen 4,"Kärna, Kungälvs kommun",110,90,200,7,860,4250000
2023-02-02,Korpedalsvägen 3,"Aröd, Kungälvs kommun",140,64,204,5,993,4000000
2023-01-19,Prästvägen 340,"Kungälv - Kareby, Kungälvs kommun",158,92,250,7,4235,6100000
2023-01-18,Granndalen 13,"Kärna, Kungälvs kommun",110,27,137,4,1093,3850000
2022-12-15,Bremnäs 130,"Lycke, Kungälvs kommun",167,40,207,8,938,4490000
2022-12-13,Bremnäs 155,"Lycke Bremnäs, Kungälvs kommun",137,53,190,6,1298,4125000
2022-12-02,Skurhagagatan 3,"Komarken, Kungälvs kommun",127,125,252,6,603,4700000
2022-11-29,Hammarberg 830,"Kode, Kungälvs kommun",73,15,88,3,1632,2900000
2022-11-18,Hältorp 130,"Ytterby, Kungälvs kommun",115,115,230,7,1372,4050000
2022-11-13,Sjöhåla 130,"Sjöhåla, Kungälvs kommun",121,75,196,4,1576,2400000
2022-11-12,Flädervägen 18,"Romelanda, Kungälvs kommun",137,20,157,6,353,3850000
2022-11-11,Lundby 440,"Kareby, Kungälvs kommun",125,120,245,5,1676,4500000
2022-11-06,Lefstad 350,"Kärna, Kungälvs kommun",129,90,219,6,2216,4050000
2022-10-21,Jägersberg 310,"Kode, Kungälvs kommun",184,28,212,6,26210,4000000
2020-06-30,Lerskärsvägen 18,"Kungälv - Tjuvkil, Kungälvs kommun",65,65,130,5,1216,3400000
2020-06-30,Bremnäs 510,"Lycke, Kungälvs kommun",85,45,130,4,2915,2350000
2020-06-29,Hövdingagatan 3,"Komarken, Kungälvs kommun",162,49,211,5,626,5300000
2020-06-28,Enekullsvägen 24,"Ytterby, Kungälvs kommun",200,24,224,7,980,5500000
2020-06-26,Bärnstensvägen 9,"Kode, Kungälvs kommun",100,95,195,5,1547,4000000
2020-06-25,Skårsäng 115,"Kärna, Kungälvs kommun",114,13,127,5,616,4400000
2020-06-24,Staby 260,"Staby, Kungälvs kommun",115,90,205,6,1125,2650000
2020-06-18,Settungsvägen 28,"Kungälv, Kungälvs kommun",141,24,165,6,429,6150000
2020-06-18,Rörtången 111C,"Rörtången, Kungälvs kommun",155,100,255,4,951,9600000
2020-06-16,Ulvesund 110,"Ytterby, Kungälvs kommun",153,50,203,5,2830,4200000
2020-06-15,Fridhemsgatan 3,"Centrum, Kungälvs kommun",108,74,182,5,851,5200000
2020-06-15,Ödsmål 360,"Rörtången, Kungälvs kommun",105,66,171,5,794,3840000
2020-06-10,Västra Röd 390,"Kärna, Kungälvs kommun",123,25,148,5,843,3295000
2020-06-10,Gårdskiftegatan 39,"Övre Tega, Kungälvs kommun",171,21,192,6,830,5450000
2020-06-09,Staby 490,"Kärna, Kungälvs kommun",100,70,170,4,2230,5000000
2020-06-09,Smidesvägen 6,"Kode, Kungälvs kommun",95,60,155,6,846,3860000
2020-06-07,Bräcke 320,"Kärna, Kungälvs kommun",148,56,204,6,7880,5850000
2020-06-05,Staby 350,"Kungälv - Kärna, Kungälvs kommun",145,75,220,5,911,3300000
2020-06-04,Berghällsvägen 10,"Kode, Kungälvs kommun",52,16,68,3,1224,2495000
2020-06-04,Lingonvägen 23,"Centralt, Kungälvs kommun",175,24,199,6,731,6150000
2020-06-03,Duvesjön 333,"Duvesjön, Kungälvs kommun",125,31,156,4,1073,3650000
2020-06-02,Dannemarksgatan 16,"Övre Tega, Kungälvs kommun",148,180,328,6,1123,5150000
2020-05-25,Staby 650,"Kärna, Kungälvs kommun",94,88,182,5,1011,3270000
2020-05-21,Östra gatan 6,"Kungälv, Kungälvs kommun",135,68,203,7,1176,6750000
2020-05-20,Dalvägen 6,"Kode, Kungälvs kommun",52,30,82,2,1378,2600000
2020-05-20,Årsnäs 300,"Kode, Kungälvs kommun",137,5,142,5,1516,5900000
2015-07-01,Flateby 180,"Harestad, Kungälvs kommun",119,98,217,6,5476,3400000
2015-06-26,Strömgatan 6,"Ytterby, Kungälvs kommun",98,71,169,5,1169,3100000
2015-06-24,Bollestad 140,"Kareby, Kungälvs kommun",110,5,115,6,19720,3200000
2015-06-17,Stora Risby 380,"Kungälv - Hålta, Kungälvs kommun",75,55,130,5,963,2200000
2015-06-16,Solvagnsgatan 16,"Ytterby - Stället, Kungälvs kommun",165,12,177,6,771,5275000
2015-06-14,Lievägen 242,"Kungälv - Ullstorp, Kungälvs kommun",122,5,127,5,236,3970000
2015-06-05,Slottsgatan 6,"Marstrand - Koön, Kungälvs kommun",126,14,140,6,340,8000000
2015-06-04,Högsberg 360,"Kode, Kungälvs kommun",72,65,137,3,2242,2500000
2015-06-04,Lefstad 190,"Bohuslän, Kungälvs kommun",65,68,133,3,1906,1975000
2015-06-03,Hanekullen 210,"Kungälv - Kareby, Kungälvs kommun",148,30,178,5,1892,4150000
2015-05-31,Länsmansvägen 2,"Ytterby, Kungälvs kommun",195,195,390,7,1753,4200000
2015-05-29,Marieberg 220,"Romelanda, Kungälvs kommun",183,12,195,5,1541,3500000
2015-05-29,Sörgårdsvägen 510,"Kungälv Kärna Sundhammar, Kungälvs kommun",200,45,245,9,1930,3660000
2015-05-29,Husfrejagatan 4,"Kungälv Iskällan, Kungälvs kommun",127,174,301,7,938,3675000
2015-05-23,Kvarnvägen 22,"Kungälv - Ingetorp, Kungälvs kommun",68,68,136,5,1318,2800000
2015-05-22,Korpvägen 265,"Kungälv, Kungälvs kommun",133,26,159,5,401,4750000
2015-05-19,Västerhöjdsvägen 14,"Kärna, Kungälvs kommun",121,20,141,5,369,950000
2015-05-19,Madängsgatan 13,"Centralt Kungälv, Kungälvs kommun",154,15,169,7,740,3995000
2015-05-18,Gråstensvägen 37,"Kode, Kungälvs kommun",107,40,147,5,1374,3420000
2015-05-08,Kållen 130,"Romelanda, Kungälvs kommun",111,53,164,5,3756,2775000
2015-05-01,Duvesjön 344,"Bohuslän, Kungälvs kommun",120,50,170,4,1136,3325000
2015-04-30,Kyrkogatan 15,"Marstrandsön, Kungälvs kommun",115,25,140,6,367,10000000
2015-04-27,Södra Ekelöv 155,"Hålta, Kungälvs kommun",140,66,206,6,2761,3395000
2015-04-23,Kungälvsvägen 73,"Grinden, Kungälvs kommun",93,51,144,5,1469,3525000
2015-04-16,Västra Röd 340,"Kärna - Harestad, Kungälvs kommun",117,66,183,6,1472,2150000
2015-04-16,Byvägen 59,"Ödsmålsmosse, Kungälvs kommun",104,20,124,4,1791,2900000
2018-12-20,Skålldal 140,"Bohuslän, Kungälvs kommun",266,42,308,8,1036,4300000
2018-12-16,Källeröd 210,"Kareby, Kungälvs kommun",121,159,280,5,2455,2550000
2018-12-12,Alelyckans väg 12,"Aröd, Kungälvs kommun",154,12,166,6,1392,3950000
2018-12-08,Kristinedalsgatan 5,"Kungälv, Kungälvs kommun",152,67,219,5,701,6650000
2018-12-07,Bollestad 152,"Ytterby, Kungälvs kommun",169,74,243,7,1762,4500000
2018-12-01,Hammar 375,"Bohuslän, Kungälvs kommun",98,65,163,6,2371,4630000
2018-11-29,Harkeröd 310,"Hålta, Kungälvs kommun",71,59,130,5,1245,3050000
2018-11-26,Ulvebackegatan 28,"Bohuslän, Kungälvs kommun",128,32,160,6,793,4750000
2018-11-21,Torp 310,"Kareby, Kungälvs kommun",149,78,227,6,3051,4300000
2018-11-21,Tyftervägen 20,"Bohuslän, Kungälvs kommun",154,13,167,5,572,4300000
2018-11-18,Häggvägen 10,"Ytterby, Kungälvs kommun",101,101,202,5,851,4170000
2018-11-18,Hemmansgatan 11,"Tega, Kungälvs kommun",133,11,144,5,756,3900000
2018-11-14,Komministergatan 3,"Kungälv - Centrum, Kungälvs kommun",120,80,200,7,678,5950000
2018-11-12,Djupuddsvägen  30,"Instön, Kungälvs kommun",135,15,150,3,1336,4800000
2018-11-09,Staby 130,"Kärna, Kungälvs kommun",109,82,191,5,9529,4020000
2018-11-09,Munkegärdegatan 253,"Munkegärde, Kungälvs kommun",134,110,244,7,899,5750000
2018-11-01,Bergåsvägen 22,"Ytterby, Kungälvs kommun",153,40,193,7,710,4500000
2018-10-30,Nordängen 10,"Sundhammar, Kungälvs kommun",174,16,190,5,1331,4900000
2018-10-29,Apelviksgatan 7,"Centrum, Kungälvs kommun",125,125,250,5,445,4750000
2018-10-28,Vesslegatan 3,"Olseröd, Kungälvs kommun",131,12,143,4,376,4500000
2018-10-26,Bärnstensvägen 6,"Kode, Kungälvs kommun",93,92,185,5,1009,3250000
2018-10-26,Solvagnsgatan 7,"Kungälv, Kungälvs kommun",137,8,145,6,362,5175000
2018-10-23,Tegskiftegatan 50,"Ytterby, Kungälvs kommun",112,57,169,5,856,4000000
2019-10-25,Fridhemsgatan 23,"Centralt, Kungälvs kommun",134,40,174,6,738,5250000
2019-10-23,Hasselvägen 1,"Diseröd, Kungälvs kommun",106,106,212,6,1032,3825000
2019-10-23,Solhultsgatan 18,"Centralt, Kungälvs kommun",152,72,224,6,555,4795000
2019-10-21,Glöskär 950,"Kungälv - Kärna, Kungälvs kommun",190,50,240,7,17790,6000000
2019-10-18,Romelandavägen 112,"Centralt, Kungälvs kommun",75,30,105,4,371,2695000
2019-10-11,Kungälvsvägen 22,"Centralt, Kungälvs kommun",77,46,123,5,1548,3760000
2019-10-04,Länsmansvägen 30,"Ytterby, Kungälvs kommun",133,55,188,5,972,4650000
2019-10-02,Gamla Trollhättevägen 11,"Centralt, Kungälvs kommun",60,36,96,3,654,3700000
2019-09-28,Bäckgatan 16,"Kungälv - Centrum, Kungälvs kommun",135,65,200,4,732,5700000
2019-09-27,Topasvägen 11,"Bohuslän, Kungälvs kommun",103,95,198,6,742,3750000
2019-09-26,Mantalsgatan 17,"Ytterby, Kungälvs kommun",189,23,212,6,986,4800000
2019-09-23,Teggatan 8,"Fridhemskullen, Kungälvs kommun",177,21,198,5,759,5900000
2019-09-18,Mellan-Restad 380,"Bohuslän, Kungälvs kommun",140,15,155,6,3583,5025000
2019-09-16,Dösebacka 620,"Romelanda, Kungälvs kommun",91,76,167,5,1498,3295000
2019-09-15,Solhultsgatan 21,"Komarken, Kungälvs kommun",173,127,300,7,560,4900000
2019-09-13,Mycklaborgsgatan 10,"Komarken, Kungälvs kommun",190,76,266,9,1110,5756725
2019-09-12,Gamla Trollhättevägen 16,"Kungälv, Kungälvs kommun",80,30,110,4,524,3300000
2019-09-03,Täljstensgatan 5,"Ytterby, Kungälvs kommun",104,19,123,4,356,4510000
2019-09-01,Hövdingagatan 7,"Komarken, Kungälvs kommun",132,48,180,7,655,4275000
2019-08-31,Lundby 460,"Kareby, Kungälvs kommun",140,38,178,5,1825,3790000
2019-08-29,Skäggstorp 120,"Kode, Kungälvs kommun",51,43,94,4,1756,2240000
2019-08-28,Stora Risby 530,"Hålta, Kungälvs kommun",62,53,115,4,925,3000000
2019-08-25,Nordängen 10,"Sundhammar, Kungälvs kommun",174,18,192,5,1331,5000000
2019-08-23,Råckeröd 170,"Kärna, Kungälvs kommun",210,85,295,7,2388,4550000
2020-01-17,Norrmannebo 540,"Norrmannebo, Kungälvs kommun",115,55,170,5,4495,3420000
2020-01-17,Gråstensvägen 11,"Kode, Kungälvs kommun",125,80,205,8,1628,3150000
2020-01-15,Guntorpsvägen 24,"Kode, Kungälvs kommun",110,152,262,6,1065,5000000
2020-01-10,Västerängen 5,"Ytterby, Kungälvs kommun",106,44,150,6,1046,5175000
2020-01-09,Holm 230,"Kovikshamn, Kungälvs kommun",155,7,162,7,2861,5875000
2020-01-03,Opalvägen 10,"Kode, Kungälvs kommun",130,50,180,5,712,2900000
2019-12-27,Ön 170,"Kareby, Kungälvs kommun",120,84,204,5,3272,3500000
2019-12-22,Solrosvägen 7,"Kärna, Kungälvs kommun",138,90,228,5,592,4375000
2019-12-06,Bergåsvägen 6B,"Ytterby, Kungälvs kommun",141,29,170,5,1021,5400000
2019-12-03,Settungsvägen 44,"Ullstorp, Kungälvs kommun",120,25,145,5,583,5100000
2019-11-30,Skurhagagatan 4,"Kungälv - Centrum, Kungälvs kommun",190,75,265,7,798,5300000
2019-11-28,Rörmossevägen 130,"Bohuslän, Kungälvs kommun",145,113,258,5,1200,4480000
2019-11-28,Törnrosgatan 10,"Ytterby, Kungälvs kommun",136,76,212,7,1030,5375000
2019-11-27,Vävra 542,"Hålta, Kungälvs kommun",109,15,124,6,1106,4550000
2019-11-25,Vallby 110,"Solberga-Kode, Kungälvs kommun",127,14,141,5,12135,5100000
2019-11-22,Olsåker 200,"Kareby, Kungälvs kommun",106,156,262,6,1673,3600000
2019-11-22,Enekullsvägen 6,"Ytterby, Kungälvs kommun",170,94,264,8,1160,6900000
2019-11-20,Solberga 870,"Kode, Kungälvs kommun",104,38,142,3,1272,3420000
2019-11-16,Trankärr 170,"Trankärr, Kungälvs kommun",86,60,146,3,1002,3880000
2019-11-13,Granndalen 13,"Kärna, Kungälvs kommun",81,10,91,4,1093,2100000
2019-11-06,Täljstensgatan 4,"Ytterby, Kungälvs kommun",70,12,82,3,478,3100000
2019-11-06,Duvesjön 357,"Romelanda, Kungälvs kommun",169,60,229,9,1054,4625000
2019-11-01,Topasvägen 13,"Kode, Kungälvs kommun",130,95,225,6,782,4500000
2019-10-30,Enebacksvägen 10,"Kode, Kungälvs kommun",69,36,105,4,1051,2720000
2019-10-30,Lerskärsvägen 11,"Tjuvkil, Kungälvs kommun",63,75,138,3,1065,2830000
2019-10-29,Jägersberg 350,"Kode, Kungälvs kommun",94,32,126,4,4120,3405000
2019-04-01,Dannemarksgatan 4,"Tega - Ytterby, Kungälvs kommun",112,151,263,6,990,4710000
2019-03-31,Alekärr 110,"Diseröd, Kungälvs kommun",118,149,267,6,1611,3500000
2019-03-25,Solvagnsgatan 22,"Ytterby - Stället, Kungälvs kommun",139,12,151,5,370,5000000
2019-03-25,Lagvägen 27,"Ytterby, Kungälvs kommun",110,38,148,6,692,3810000
2019-03-13,Skolstigen 2,"Kungälv, Kungälvs kommun",150,20,170,7,1080,4570000
2019-03-06,Munkegärdegatan 99,"Blodriskan, Kungälvs kommun",134,25,159,5,345,4350000
2019-02-28,Flateby 450,"Harestad, Kungälvs kommun",163,118,281,8,1351,3630000
2019-02-27,Prästvägen 710,"Romelanda, Kungälvs kommun",166,20,186,8,1034,4300000
2019-02-24,Granndalen 14,"Bohuslän, Kungälvs kommun",70,54,124,4,1229,2995000
2019-02-21,Kvarnvägen 22,"Kode, Kungälvs kommun",68,68,136,5,1318,3570000
2019-02-15,Hamngatan 11,"Centralt, Kungälvs kommun",84,94,178,3,636,4890000
2019-02-14,Rönnvägen  22,"Romelanda, Kungälvs kommun",108,70,178,5,823,3375000
2019-02-14,Lyckevägen  9,"Kärna, Kungälvs kommun",190,150,340,9,2284,4300000
2019-02-14,Ekvägen 12,"Ytterby, Kungälvs kommun",125,83,208,6,770,4000000
2019-02-12,Tjuvkil 460,"Tjuvkil, Kungälvs kommun",115,20,135,4,1231,3900000
2019-02-11,Sjöhed 310,"Kärna - Harestad, Kungälvs kommun",103,81,184,5,1208,3700000
2019-02-11,Galärgatan 3,"Komarken, Kungälvs kommun",108,65,173,4,628,4200000
2019-02-08,Bastövägen 4,"Överön - Kärna, Kungälvs kommun",100,60,160,6,2786,4995000
2019-02-07,Furuvägen 1,"Diseröd, Kungälvs kommun",108,32,140,5,742,2795000
2019-02-04,Hallsbrovägen  14,"Kärna, Kungälvs kommun",145,61,206,6,2108,3700000
2019-02-01,Lyckevägen 3,"Kärna, Kungälvs kommun",120,72,192,5,2857,3770000
2019-01-24,Galeasgatan 17,"Centrum, Kungälvs kommun",189,100,289,6,574,5425000
2019-01-21,Gategården 250,"Hålta, Kungälvs kommun",140,26,166,5,1500,3990000
2019-01-20,Kantorvägen 3,"Diseröd centrum, Kungälvs kommun",165,14,179,5,761,4100000
2019-01-19,Hemvägen  15,"Romelanda, Kungälvs kommun",119,19,138,5,398,3550000
2019-01-17,Rörmossevägen  120,"Bohuslän, Kungälvs kommun",170,81,251,5,4070,4575000
2019-01-11,Kristiansborg 170,"Tjuvkil, Kungälvs kommun",77,55,132,6,1295,3700000
2015-11-09,Bergliden 20,"Aröd, Kungälvs kommun",65,36,101,3,1322,2210000
2015-11-02,Jörlandavägen 3,"Kode, Kungälvs kommun",115,48,163,5,1165,2325000
2015-11-02,Häljeröd 320,"Romelanda, Kungälvs kommun",144,24,168,5,5814,3950000
2015-10-30,Rådmansgatan 13,"Centrum, Kungälvs kommun",92,92,184,5,636,4900000
2015-10-30,Lundby 180,"Kareby, Kungälvs kommun",200,63,263,7,1518,3400000
2015-10-30,Vedhallsvägen 8,"Kärna, Kungälvs kommun",116,72,188,6,1864,2250000
2015-10-22,Stora Ryr 280,"Bohuslän, Kungälvs kommun",96,15,111,3,2254,1950000
2015-10-20,Fontinvägen 22,"Kungälv - Centrum, Kungälvs kommun",130,140,270,8,1034,5900000
2015-10-19,Gamla Trollhättevägen 22,"Kungälv, Kungälvs kommun",65,60,125,2,1246,2000000
2015-10-18,Settungsvägen 36,"Kungälv Ullstorp, Kungälvs kommun",140,20,160,6,362,4800000
2015-10-16,Bergåsvägen 21,"Ytterby Tunge, Kungälvs kommun",130,70,200,6,972,3570000
2015-10-14,Kämpegatan 5,"Kungälv Centralt, Kungälvs kommun",107,105,212,6,842,3850000
2015-10-14,Häljeröd 330,"Kungälv, Kungälvs kommun",145,5,150,6,6686,4055500
2015-10-14,Mjölnarvägen 14,"Romelanda, Kungälvs kommun",124,85,209,5,820,3200000
2015-10-13,Hjälmgatan 9,"Ytterby, Kungälvs kommun",96,6,102,3,467,3225000
2015-10-12,Rävo 130,"Hålta, Kungälvs kommun",114,114,228,5,5500,4350000
2015-10-08,Ulvesund 110,"Ytterby, Kungälvs kommun",153,50,203,4,3024,3200000
2015-10-07,Bärnstensvägen 11,"Kode, Kungälvs kommun",98,75,173,6,1005,3195000
2015-09-28,Rosenstensvägen 11,"Kode, Kungälvs kommun",140,15,155,5,562,3350000
2015-09-24,Ingetorp 130,"Kode, Kungälvs kommun",120,60,180,5,1874,3050000
2015-09-22,Solvagnsgatan 42,"Ytterby - Stället, Kungälvs kommun",138,12,150,5,401,4325000
2015-09-16,Stämmdalen 120,"Lycke, Kungälvs kommun",96,66,162,5,1104,1895000
2015-09-13,Lökebergsvägen 27,"Kungälv Lökeberg, Kungälvs kommun",120,45,165,5,1198,3840000
2015-09-11,Brunnefjäll 180,"Kärna Vedhall, Kungälvs kommun",143,60,203,5,1887,3470000
2015-09-10,Häljeröd 270,"Romelanda - Diseröd, Kungälvs kommun",111,88,199,6,3100,2495000
2015-09-10,Buderöd 160,"Kode, Kungälvs kommun",118,84,202,5,22600,4075000
2015-09-09,Tegskiftegatan 48,"Ytterby Tega Kungälv, Kungälvs kommun",157,102,259,9,1083,4950000
2015-09-03,Broberg 130,"Bohuslän, Kungälvs kommun",130,37,167,6,2400,3425000
2015-09-02,Sköldgatan 4,"Ytterby, Kungälvs kommun",95,8,103,3,399,3075000
2015-08-31,Käckås 110,"Ytterby, Kungälvs kommun",98,87,185,5,11226,4400000
2015-08-28,Diserödsvägen 7,"Kungälv Romelanda Diseröd, Kungälvs kommun",127,52,179,5,737,2830000
2015-08-26,Västra Strandgatan 17,"Kungälv - Centrum, Kungälvs kommun",130,80,210,5,690,3575000
2015-07-30,Toftebergsvägen 2,"Tjuvkil, Kungälvs kommun",82,6,88,4,1085,1550000
2015-07-24,Truskärsvägen 7,"Tjuvkil, Kungälvs kommun",181,83,264,6,3390,4350000
2015-07-10,Lundby 450,"Kungälv - Kareby, Kungälvs kommun",125,142,267,5,2522,3525000
2015-07-09,Solskiftegatan 63,"Övre Tega - Ytterby, Kungälvs kommun",171,31,202,6,810,4300000
2020-09-08,Stora Ryr 110,"Lycke, Kungälvs kommun",116,76,192,7,1434,3795000
2020-09-08,Kungälvsvägen 64,"Centralt, Kungälvs kommun",137,58,195,5,853,5350000
2020-09-05,Prejelvägen 117,"Ullstorp, Kungälvs kommun",122,15,137,5,596,5560000
2020-08-30,Grönviksvägen 22,"Kärna / Sundhammar, Kungälvs kommun",130,70,200,4,1741,6800000
2020-08-23,Romelandavägen 110,"Centralt, Kungälvs kommun",125,37,162,4,701,3700000
2020-08-21,Gråstensvägen 14,"Kode, Kungälvs kommun",94,96,190,5,1424,3550000
2020-08-20,Rävo 120,"Hålta, Kungälvs kommun",96,64,160,5,1819,2300000
2020-08-17,Rådmansgatan 21,"Kungälv - Centrum, Kungälvs kommun",120,74,194,5,964,6530000
2020-08-13,Lingonvägen 11,"Centralt, Kungälvs kommun",123,24,147,4,742,5700000
2020-08-12,Munkegärdegatan 313,"Munkegärde, Kungälvs kommun",135,20,155,5,309,4800000
2020-08-12,Norrmannebo 440,"Romelanda, Kungälvs kommun",81,79,160,5,2036,3550000
2020-08-12,Rostock 170,"Romelanda, Kungälvs kommun",84,88,172,4,1544,3500000
2020-08-10,Hallbjörtorp 350,"Kärna, Kungälvs kommun",130,40,170,7,80081,5100000
2020-08-03,Spaghamnsvägen 10,"Tjuvkil nära Marstrand, Kungälvs kommun",165,20,185,5,1280,12500000
2020-07-30,Hålta Annex 110,"Hålta, Kungälvs kommun",217,8,225,8,42350,7250000
2020-07-28,Lid 170,"Diseröd, Kungälvs kommun",86,51,137,4,6235,2460000
2020-07-25,Bergsgatan 10,"Marstrand Koön, Kungälvs kommun",175,100,275,6,896,6900000
2020-07-24,Bråta 140,"Romelanda, Kungälvs kommun",35,5,40,3,2165,1475000
2020-07-22,Hallebäcksvägen 13,"Timmervik, Kungälvs kommun",113,50,163,5,3636,4875000
2020-07-21,Ametistvägen 4,"Kode, Kungälvs kommun",98,95,193,5,866,4400000
2020-07-10,Holm 310,"Kungälv - Kärna, Kungälvs kommun",66,36,102,3,2077,2970000
2020-07-02,Knaverstad-Ryr 580,"Aröd, Kungälvs kommun",158,4,162,6,1012,3650000
2020-07-01,Pölen 120,"Kungälv - Hålta, Kungälvs kommun",138,75,213,5,812,4800000
2023-06-16,Solberg 420,"Romelanda, Kungälvs kommun",90,65,155,3,2968,2350000
2023-06-15,Kovikshamn 160,"Kovikshamn, Kungälvs kommun",124,8,132,4,1400,4300000
2023-06-14,Blankas gata 3,"Kungälv - Centralt, Kungälvs kommun",130,152,282,7,980,6350000
2023-06-08,Erslycke 140,"Lycke, Kungälvs kommun",162,24,186,5,1820,5700000
2023-06-01,Bergkristallvägen 8,"Kode, Kungälvs kommun",127,8,135,4,518,4795000
2023-05-25,Krappvägen 570,"Ullstorp, Kungälvs kommun",230,25,255,8,788,9500000
2023-05-19,Norrmannebo 650,"Bohuslän, Kungälvs kommun",143,50,193,6,20500,5800000
2023-05-18,Ängsgatan  23,"Centralt, Kungälvs kommun",91,87,178,5,743,4625000
2023-05-17,Östergårdsgatan 3,"Ytterby, Kungälvs kommun",215,62,277,7,1020,4860000
2023-05-15,Toreby 240,"Kärna, Kungälvs kommun",89,89,178,5,1245,3405000
2023-05-12,Murhammarvägen 12,"Kungälv - Kareby, Kungälvs kommun",174,17,191,6,700,5200000
2023-05-08,Kämpegatan 4,"Kungälv Centrum, Kungälvs kommun",128,43,171,5,1160,5000000
2023-05-07,Vesslegatan 14,"Olseröd, Kungälvs kommun",159,17,176,5,349,5550000
2023-05-04,Bastubäcksvägen 26,"Kode, Kungälvs kommun",44,36,80,4,1199,1775000
2023-04-30,Vävra 297,"Hålta, Kungälvs kommun",161,55,216,5,1587,5300000
2023-04-29,Lerskärsvägen 8,"Tjuvkil, Kungälvs kommun",84,50,134,4,1458,4500000
2023-04-26,Brunnefjällsvägen 21,"Kärna, Kungälvs kommun",82,13,95,3,1741,3500000
2023-04-25,Sålådevägen 546,"Kungälv - Ullstorp, Kungälvs kommun",145,19,164,5,804,6700000
2023-04-21,Östra Trädal 320,"Ytterby, Kungälvs kommun",130,50,180,6,8185,7495000
2023-04-18,Kuskalundsvägen 39,"Kungälv - Hålta, Kungälvs kommun",70,13,83,3,1745,2600000
2023-04-10,Stora Risby 550,"Hålta, Kungälvs kommun",100,86,186,3,1640,3850000
2023-04-03,Västra gatan 28,"Kungälv - Centralt, Kungälvs kommun",155,32,187,6,600,5250000
2023-03-30,Östergårdsgatan 23,"Ytterby, Kungälvs kommun",180,48,228,6,840,5225000
2023-03-24,Kullegatan 12,"Centrum, Kungälvs kommun",190,163,353,7,660,6600000
2014-06-11,Kristinedalsgatan 6,"Centralt, Kungälvs kommun",177,67,244,6,802,4250000
2014-05-31,Illekärr 170,"Kungälv - Romelanda, Kungälvs kommun",152,80,232,6,6070,2720000
2014-05-27,Lagvägen 53,"Kungälv - Ytterby, Kungälvs kommun",157,51,208,6,779,2950000
2014-05-22,Skårby Station 150,"Kareby, Kungälvs kommun",97,50,147,4,3446,2020000
2014-05-20,Solberga 510,"Solberga - Kode, Kungälvs kommun",98,58,156,5,1517,2215000
2014-05-17,Löstorp 130,"Kareby, Kungälvs kommun",171,7,178,6,4580,4200000
2014-05-10,Åsleröd 110,"Ytterby, Kungälvs kommun",57,57,114,3,975,1470000
2014-04-29,Rådalsvägen 7,"Aröd, Kungälvs kommun",60,31,91,5,1500,2500000
2014-04-22,Parken 110,"Solberga Kode, Kungälvs kommun",157,100,257,5,4160,3950000
2014-04-16,Kämpegatan 7,"Centralt, Kungälvs kommun",121,103,224,6,899,3125000
2014-04-12,Grokareby 110,"Kareby, Kungälvs kommun",120,80,200,4,2367,2400000
2014-03-26,Heden 190,"Kärna - Harestad, Kungälvs kommun",74,45,119,4,2064,2482000
2014-03-26,Mantalsgatan 9,"Ytterby, Kungälvs kommun",175,35,210,8,1105,3850000
2014-03-20,Vältvägen 509,"Ullstorp, Kungälvs kommun",105,10,115,4,319,3160000
2014-03-13,Topasvägen 11,"Kode, Kungälvs kommun",103,95,198,6,742,2375000
2014-03-11,Häljeröd 550,"Kode, Kungälvs kommun",135,35,170,4,3880,2530000
2014-03-07,Lagvägen 31,"Ytterby, Kungälvs kommun",89,76,165,4,1330,2175000
2014-03-05,Helgonagatan 192,"Munkegärde, Kungälvs kommun",93,21,114,5,191,2900000
2014-03-04,Högalidsgatan 5,"Centralt, Kungälvs kommun",109,109,218,4,805,2820000
2014-02-27,Solhultsgatan 17,"Centralt, Kungälvs kommun",189,15,204,8,481,2900000
2014-02-20,Gunneröd 270,"Lycke, Kungälvs kommun",57,45,102,4,2646,1850000
2014-02-08,Ulvesund 410,"Ytterby-Ulvesund, Kungälvs kommun",77,25,102,5,795,2230000
2014-02-03,Ulvebackegatan 12,"Ulvegärde, Kungälvs kommun",140,38,178,5,914,3625000
2014-01-21,Fridhemsgatan 9,"Centralt, Kungälvs kommun",137,90,227,6,850,3525000
2014-01-17,Bärnstensvägen 6,"Kode, Kungälvs kommun",93,92,185,4,1009,2275000
2014-01-15,Prejelvägen 110,"Ullstorp, Kungälvs kommun",122,5,127,5,320,3230000
2013-12-16,Hällristningsgatan 15,"Stället, Kungälvs kommun",107,5,112,5,430,3300000
2013-12-12,Väktaregatan 5,"Centralt, Kungälvs kommun",142,70,212,6,566,4850000
2013-12-06,Solskiftegatan 9,"Tega, Kungälvs kommun",140,58,198,6,958,2850000
2016-04-06,Gårdskiftegatan 64,"Ytterby, Kungälvs kommun",139,31,170,7,803,3200000
2016-04-04,Lahälla 610,"Skåra, Kungälvs kommun",160,82,242,6,2098,5450000
2016-03-29,Plogvägen 203,"Kungälv, Kungälvs kommun",122,9,131,5,295,4480000
2016-03-24,Solskiftegatan 9,"Kungälv, Kungälvs kommun",140,58,198,6,958,3850000
2016-03-22,Matskärsvägen 37,"Tjuvkil, Kungälvs kommun",83,48,131,5,1430,3530000
2016-03-21,Flateby 490,"Harestad, Kungälvs kommun",165,67,232,7,1030,1995000
2016-03-16,Näckrosvägen 7,"Kärna, Kungälvs kommun",148,75,223,6,1553,4220000
2016-03-09,Duvesjön 368,"Romelanda, Kungälvs kommun",117,35,152,5,1132,3225000
2016-03-08,Stora Ryr 340,"Kärna, Kungälvs kommun",144,12,156,5,952,2900000
2016-03-04,Björkliden 18,"Aröd, Kungälvs kommun",60,60,120,3,1050,2470000
2016-03-02,Kärnavägen 27,"Kärna, Kungälvs kommun",150,30,180,6,862,3730000
2016-02-24,Stenhålt 125,"Romelanda, Kungälvs kommun",157,38,195,6,5000,3275000
2016-02-24,Hasselvägen 7,"Romelanda, Kungälvs kommun",134,48,182,7,977,3410000
2016-02-20,Tegskiftegatan 46,"Tega, Kungälvs kommun",114,117,231,8,865,4100000
2016-02-15,Staby 340,"Kärna, Kungälvs kommun",159,125,284,6,1207,4500000
2016-02-11,Tulpanvägen 4,"Kärna, Kungälvs kommun",118,70,188,6,783,3500000
2016-02-10,Östergårdsgatan 31,"Ytterby, Kungälvs kommun",154,54,208,6,809,3880000
2016-02-09,Oskarsbergsgatan 20,"Ytterby, Kungälvs kommun",120,68,188,6,929,4020000
2016-01-29,Byvägen 20,"Kode, Kungälvs kommun",64,25,89,4,1642,2600000
2016-01-26,Reidarsgatan 5,"Komarken, Kungälvs kommun",119,57,176,6,686,2650000
2016-01-19,Bredsten 416,"Ytterby, Kungälvs kommun",158,14,172,6,26920,6800000
2016-01-18,Skårby Station 520,"Kareby, Kungälvs kommun",117,55,172,5,1060,2995000
2016-01-18,Vena 170,"Vena - Ytterby, Kungälvs kommun",183,1,184,6,2650,3700000
2016-01-13,Hanekullen 205,"Kareby, Kungälvs kommun",90,90,180,2,1885,3900000
2016-01-13,Smaragdvägen 30,"Kode, Kungälvs kommun",131,14,145,5,362,3430000
2016-01-10,Mantalsgatan 26,"Tega - Ytterby, Kungälvs kommun",153,54,207,7,1922,4570000
2016-01-05,Skepparegatan 5,"Marstrand - Koön, Kungälvs kommun",184,25,209,9,474,8000000
2015-12-22,Spadvägen 1,"Ullstorp, Kungälvs kommun",75,40,115,3,1236,2970000
2015-12-08,Timmervik 140,"Bohuslän, Kungälvs kommun",180,45,225,7,1119,3695000
2015-12-06,Häljeröd 490,"Bohuslän, Kungälvs kommun",205,100,305,9,4355,4975000
2015-11-17,Mossvägen 13,"Kungälv Lökeberg, Kungälvs kommun",96,10,106,4,1376,2600000
2018-07-07,Bufferöd 150,"Kungälv - Hålta, Kungälvs kommun",130,130,260,6,1209,4550000
2018-07-06,Dösebacka 310,"Romelanda, Kungälvs kommun",102,97,199,4,949,3450000
2018-07-06,Tegskiftegatan 20,"Ytterby, Kungälvs kommun",102,102,204,6,969,4525000
2018-06-21,Skårby mosse 930,"Kareby, Kungälvs kommun",167,20,187,7,1299,3800000
2018-06-15,Klåverön 460,"Marstrand, Kungälvs kommun",76,76,152,4,2303,4300000
2018-06-13,Dösebacka 630,"Diseröd, Kungälvs kommun",84,84,168,4,1407,2000000
2018-06-13,Bergsgatan 2,"Marstrand - Koön, Kungälvs kommun",118,82,200,6,892,8600000
2018-06-08,Väktaregatan 9,"Bohuslän, Kungälvs kommun",166,83,249,8,538,5300000
2018-06-07,Lundby 220,"Kareby, Kungälvs kommun",146,45,191,5,1943,4650000
2018-06-03,Bastövägen 12,"Kärna, Kungälvs kommun",80,80,160,6,1024,4200000
2018-06-02,Kuskalundsvägen 39,"Bohuslän, Kungälvs kommun",59,13,72,3,1745,2270000
2018-06-02,Korpedalsvägen 3,"Aröd, Kungälvs kommun",115,85,200,5,993,3720000
2018-05-30,Solberga 790,"Kode, Kungälvs kommun",70,60,130,4,1380,3550000
2018-05-25,Vrångholmen 150,"Marstrand/Kråkerön, Kungälvs kommun",185,34,219,6,2207,11000000
2018-05-24,Bäckvägen 10,"Lökeberg, Kungälvs kommun",55,5,60,4,1091,3910000
2018-05-22,Rörmossevägen 240,"Rörmossen, Kungälvs kommun",58,15,73,3,5170,2215000
2018-05-22,Lievägen 228,"Kungälv Ullstorp, Kungälvs kommun",125,10,135,4,250,4750000
2018-05-22,Lökebergsvägen 18,"Lökeberg, Kungälvs kommun",110,65,175,4,55368,6225000
2018-05-17,Hermansby 228,"Kärna, Kungälvs kommun",165,58,223,5,1503,5825000
2018-05-17,Gategården 260,"Risby/Hålta, Kungälvs kommun",120,71,191,5,2337,5020000
2018-05-16,Brunnefjäll 110,"Kärna, Kungälvs kommun",121,185,306,6,2124,3750000
2018-05-16,Sandvik 110,"HARESTAD, Kungälvs kommun",153,36,189,5,998,3400000
2018-05-14,Galeasgatan 15,"Kungälv, Kungälvs kommun",103,64,167,5,610,3500000
2018-05-07,Brunnefjäll 190,"Kärna, Kungälvs kommun",83,50,133,4,1536,2810000
2018-05-06,Enekullsvägen 32,"Ytterby, Kungälvs kommun",101,20,121,4,807,3570000
2018-05-03,Dannemarksgatan 39,"Ytterby, Kungälvs kommun",159,32,191,6,730,4000000
2018-05-02,Byvägen 22,"Ödsmålsmosse, Kungälvs kommun",43,24,67,3,1930,2500000
2018-04-06,Bokvägen 5,"Kungälv centralt, Kungälvs kommun",89,89,178,5,635,4450000
2021-08-22,Fontinvägen 16,"Bohuslän, Kungälvs kommun",135,35,170,6,1012,6125000
2021-08-21,Västra gatan 6,"Bohuslän, Kungälvs kommun",326,231,557,12,693,11000000
2021-08-20,Kuskalundsvägen 36,"HÅLTA, Kungälvs kommun",138,23,161,6,1339,4100000
2021-08-19,Gömmet 120,"Romelanda, Kungälvs kommun",197,19,216,5,2800,5250000
2021-08-16,Gunneröd 200,"Kärna, Kungälvs kommun",40,10,50,3,789,2490000
2021-08-16,Ödsmål 360,"Ödsmål, Kungälvs kommun",105,66,171,6,794,4700000
2021-08-10,Metesten 150,"Harestad, Kungälvs kommun",131,19,150,5,1507,4300000
2021-08-09,Sjöhåla 580,"Kärna, Kungälvs kommun",94,87,181,5,1068,3490000
2021-08-04,Munkholmsgatan 8,"Kungälv - Centralt, Kungälvs kommun",120,60,180,7,639,6100000
2021-08-02,Hallsbrovägen 14,"Kärna, Kungälvs kommun",145,61,206,5,2108,4500000
2021-07-29,Väktaregatan 9,"Centralt, Kungälvs kommun",166,83,249,9,538,6900000
2021-07-23,Rådmansgatan 11,"Kungälv Centralt, Kungälvs kommun",167,122,289,6,547,6800000
2021-07-21,Flateby 470,"Harestad, Kungälvs kommun",61,7,68,3,1409,2800000
2021-07-20,Rondan 20,"Ödsmålsmosse, Kungälvs kommun",82,75,157,4,1326,3900000
2021-07-13,Bergåsvägen 26,"Ytterby, Kungälvs kommun",184,55,239,4,891,6450000
2021-07-10,Olserödsgatan 118,"Olseröd, Kungälvs kommun",127,24,151,6,910,6200000
2021-07-09,Gömmet 110,"Romelanda, Kungälvs kommun",153,24,177,3,30000,5600000
2021-07-08,Olsåker 110,"Kareby, Kungälvs kommun",139,60,199,6,16226,5900000
2021-07-06,Olvonvägen 17,"Diseröd, Kungälvs kommun",162,17,179,7,683,5300000
2021-07-05,Bäckvägen 8,"Lökeberg, Kungälvs kommun",85,43,128,4,1016,2750000
2021-07-03,Rävsal 170,"Olseröd, Kungälvs kommun",124,50,174,5,2514,3525000
2021-06-28,Klintegatan 8,"Kungälv - Centralt, Kungälvs kommun",130,80,210,7,778,7100000
2021-06-24,Marias väg 17,"Aröd, Kungälvs kommun",99,34,133,4,1318,4700000
2021-06-24,Skårby station 130,"Kareby, Kungälvs kommun",89,96,185,4,1686,2600000
2021-06-22,Lilla Ryr 170,"Lycke, Kungälvs kommun",40,9,49,2,1345,2900000
2021-06-22,Prästvägen 450,"Kareby, Kungälvs kommun",116,50,166,4,2572,4600000
2021-06-21,Ekliden 8,"Centralt, Kungälvs kommun",67,66,133,3,1041,5000000
2021-06-19,Vedhall 120,"Kärna, Kungälvs kommun",88,49,137,4,2105,6500000
2021-06-18,Toreby 200,"Bohuslän, Kungälvs kommun",103,130,233,4,2391,4100000
2021-06-17,Häljeröd 300,"Kungälv - Romelanda, Kungälvs kommun",223,25,248,7,3547,6900000
2021-06-15,Skutviksvägen 3,"Marstrand - Instön, Kungälvs kommun",42,3,45,3,1223,4750000
2021-06-10,Helgonagatan 157,"Munkegärde, Kungälvs kommun",109,109,218,7,903,5025000
2021-06-09,Dannemarksgatan 14,"Ytterby-Tega, Kungälvs kommun",210,86,296,8,1203,6250000
2017-05-26,Dalvägen 17,"Ödsmåls mosse/Rörtången, Kungälvs kommun",45,40,85,5,1036,2395000
2017-05-25,Fredkullagatan 21,"Centrum, Kungälvs kommun",130,130,260,7,978,5710000
2017-05-19,Husfrejagatan 6,"Iskällan, Kungälvs kommun",152,52,204,6,938,5400000
2017-05-16,Västerhöjdsvägen 24,"Kärna, Kungälvs kommun",150,15,165,6,728,5300000
2017-05-10,Fregattgatan 2,"Kungälv, Kungälvs kommun",217,26,243,7,781,4650000
2017-05-08,Jakobsvägen 21-23,"Aröd, Kungälvs kommun",95,65,160,5,2963,4550000
2017-05-04,Tolleröd 115,"Kode, Kungälvs kommun",120,100,220,7,2130,4295000
2017-05-02,Situlagatan 3,"YTTERBY, Kungälvs kommun",154,16,170,6,795,5600000
2017-05-01,Kvarndalsvägen 40,"Lökeberg, Kungälvs kommun",56,36,92,3,1089,2650000
2017-04-26,Bergkristallvägen 21,"Kode, Kungälvs kommun",127,10,137,6,531,4250000
2017-04-25,Bergkristallvägen 3,"Kode, Kungälvs kommun",125,9,134,4,527,4500000
2017-04-16,Tryggvasons gata 1,"Iskällan, Kungälvs kommun",135,40,175,7,785,6500000
2017-04-16,Snäckvägen 19,"Ödsmåls mosse/Rörtången, Kungälvs kommun",90,17,107,4,1184,3600000
2017-04-07,Fontinvägen 42,"Centrum, Kungälvs kommun",118,7,125,4,440,4600000
2017-04-07,Solberga 510,"Solberga-Kode, Kungälvs kommun",98,58,156,5,1517,2990000
2017-03-16,Stenåldersgatan 12,"Ytterby Stället, Kungälvs kommun",104,7,111,4,357,4000000
2017-03-15,Hövdingagatan 4,"Centrum, Kungälvs kommun",115,137,252,7,906,5325000
2017-03-03,Komministergatan 10,"Kungälv - Centrum, Kungälvs kommun",145,125,270,9,659,6550000
2017-03-02,Vävra 800,"Hålta, Kungälvs kommun",148,18,166,9,6109,4460000
2017-03-02,Arntorp 220,"Kareby, Kungälvs kommun",138,24,162,6,2125,4200000
2017-02-24,Rishammar 110,"Kareby, Kungälvs kommun",140,19,159,6,1205,3550000
2022-06-22,Halltorpsvägen 11,"Kode, Kungälvs kommun",107,13,120,4,1119,4800000
2022-06-21,Duvesjön 351,"Romelanda, Kungälvs kommun",50,35,85,2,2418,1750000
2022-06-20,Äslingsvägen 10,"Tjuvkil, Kungälvs kommun",75,43,118,4,1355,4150000
2022-06-17,Almvägen 9,"Romelanda, Kungälvs kommun",129,10,139,6,803,5260000
2022-06-15,Östergårdsgatan 23,"Ytterby, Kungälvs kommun",180,48,228,6,840,5600000
2022-06-15,Åsleröd 130,"Bohuslän, Kungälvs kommun",120,35,155,4,1566,4700000
2022-06-11,Situlagatan 4,"Ytterby - Stället, Kungälvs kommun",138,27,165,5,636,6620000
2022-06-09,Duvesjön 373,"Duvesjön, Kungälvs kommun",149,9,158,5,1604,4900000
2022-06-08,Östra gatan 29,"Kungälv, Kungälvs kommun",192,128,320,8,384,8300000
2022-06-03,Bergåsvägen 10B,"Ytterby, Kungälvs kommun",115,78,193,6,834,5700000
2022-05-29,Sagagatan 6,"Centralt vid älven, Kungälvs kommun",280,45,325,6,768,8500000
2022-05-27,Glose 120,"Glose, Kungälvs kommun",64,64,128,4,1418,3500000
2022-05-26,Toreby 240,"Kärna, Kungälvs kommun",89,89,178,4,1245,3895000
2022-05-26,Tronnum 370,"Kärna, Kungälvs kommun",165,36,201,5,2407,6360000
2022-05-23,Ängsgatan 9,"Centrum, Kungälvs kommun",165,16,181,6,575,5700000
2022-05-22,Storskiftegatan 35,"Övre Tega, Kungälvs kommun",84,11,95,3,255,4000000
2022-05-17,Rörstigen 8,"Centralt vid älven, Kungälvs kommun",129,2,131,5,407,6200000
2022-05-16,Bäckvägen 2,"Kungälv - Lökeberg, Kungälvs kommun",95,48,143,3,1050,6300000
2022-05-16,Hagtornsvägen 1,"Diseröd, Kungälvs kommun",120,107,227,7,788,4650000
2022-05-13,Åsebyberg 870,"Åsebyberg, Kungälvs kommun",117,72,189,4,2667,4900000
2022-05-12,Aspvägen 8,"Ytterby, Kungälvs kommun",130,90,220,5,602,6210000
2022-04-27,Torsbyvägen 50,"Ytterby, Kungälvs kommun",101,49,150,4,4904,5550000
2022-04-25,Åsebyberg 855,"Åsebyberg, Kungälvs kommun",129,18,147,5,4105,5000000
2020-11-10,Duvesjön 359,"Diseröd, Kungälvs kommun",117,40,157,4,1091,4170000
2020-11-09,Dalvägen 17,"Ödsmålsmosse, Kungälvs kommun",45,40,85,4,1036,2800000
2020-10-29,Kornhall 210,"Kornhall, Kungälvs kommun",110,22,132,5,570,4060000
2020-10-26,Nolhagsvägen 22,"Aröd, Kungälvs kommun",102,71,173,5,3489,5000000
2020-10-23,Solberga 510,"Solberga, Kungälvs kommun",98,58,156,4,1517,4195000
2020-10-23,Grindbacken 17,"Grinden, Kungälvs kommun",191,20,211,6,958,8600000
2020-10-19,Nämndemansvägen 25,"Ytterby, Kungälvs kommun",136,25,161,4,560,4850000
2020-10-13,Överås 110,"Ytterby, Kungälvs kommun",168,57,225,6,26600,6545000
2020-10-09,Hagtornsvägen 7,"Diseröd, Kungälvs kommun",112,112,224,6,825,4500000
2020-09-28,Korpvägen 265,"Ullstorp, Kungälvs kommun",133,18,151,6,401,5950000
2020-09-26,Hallbjörtorp 370,"Kärna, Kungälvs kommun",30,30,60,2,1535,2900000
2020-09-26,Rådmansgatan 4,"Kungälv - Centrum, Kungälvs kommun",221,10,231,6,678,6400000
2020-09-24,Häljeröd 390,"Diseröd, Kungälvs kommun",115,37,152,5,3700,4500000
2020-09-24,Grenvägen 9,"Tjuvkil, Kungälvs kommun",56,2,58,3,1215,2530000
2020-09-24,Solskiftegatan 29,"Ytterby, Kungälvs kommun",192,56,248,7,932,5700000
2020-09-23,Hermelingatan 11,"Kungälv - Olseröd, Kungälvs kommun",126,25,151,5,548,5600000
2020-09-21,Havregången 11,"Centrum, Kungälvs kommun",150,42,192,4,588,4400000
2020-09-18,Länsmansvägen 5,"Ytterby, Kungälvs kommun",108,136,244,5,573,4600000
2020-09-17,Duvesjön 302,"Duvesjön, Kungälvs kommun",120,74,194,4,1506,5615000
2020-09-15,Västerhöjdsvägen 40,"Kärna, Kungälvs kommun",107,8,115,4,274,4100000
2020-09-13,Dösebacka 450,"Diseröd, Kungälvs kommun",104,40,144,5,4320,3520000
2020-09-11,Fjärdingsgatan 9,"Ytterby, Kungälvs kommun",120,68,188,5,1680,4650000
2020-09-09,Trankärr 210,"Centralt, Kungälvs kommun",209,47,256,8,2855,6700000
2020-09-09,Trankärr 230,"Centralt, Kungälvs kommun",152,34,186,6,2056,4795000
2021-02-09,Gamla Trollhättevägen 6,"Centralt, Kungälvs kommun",210,170,380,8,1368,7600000
2021-02-08,Lybeck 151,"Diseröd, Kungälvs kommun",117,40,157,4,1572,5120000
2021-02-05,Furuvägen 8,"Diseröd, Kungälvs kommun",102,102,204,4,715,3100000
2021-02-03,Settungsvägen 48,"Ullstorp, Kungälvs kommun",123,22,145,4,543,5935000
2021-02-03,Toftebergsvägen 2,"Tjuvkil, Kungälvs kommun",85,6,91,3,1085,3895000
2021-01-29,Lyckevägen 5C,"Kärna, Kungälvs kommun",95,61,156,3,1060,4500000
2021-01-28,Rishammarvägen 2,"Kareby, Kungälvs kommun",155,62,217,8,2086,6770000
2021-01-24,Håkons gata 2,"Centrum, Kungälvs kommun",124,124,248,6,1006,5350000
2021-01-21,Täljstensgatan 4,"Ytterby, Kungälvs kommun",70,12,82,3,478,3600000
2021-01-13,Kantorvägen 3,"Bohuslän, Kungälvs kommun",165,14,179,5,761,4625000
2021-01-12,Holm 160,"Kärna, Kungälvs kommun",143,108,251,5,3125,4525000
2021-01-07,Skårby station 215,"Kareby, Kungälvs kommun",95,88,183,5,1498,3700000
2020-12-21,Munkegärdegatan 253,"Kungälv Munkegärde, Kungälvs kommun",134,110,244,8,899,6060000
2020-12-09,Oxelvägen 80,"Diseröd, Kungälvs kommun",139,20,159,7,751,5475000
2020-12-02,Bollestad 130,"Kareby, Kungälvs kommun",145,55,200,6,1554,3975000
2020-11-29,Kroken 210,"Bohuslän, Kungälvs kommun",139,39,178,6,1447,5500000
2020-11-28,Mellan-Restad 355,"Bohuslän, Kungälvs kommun",70,15,85,4,851,4160000
2020-11-19,Ametistvägen 1,"Kode, Kungälvs kommun",98,92,190,5,936,4135000
2020-11-13,Barlinds väg 23,"Marstrand - Instön, Kungälvs kommun",114,5,119,5,1340,7000000
2022-09-29,Heden 220,"Bohuslän, Kungälvs kommun",123,77,200,5,3342,4750000
2022-09-28,Gustavsbergsvägen 16,"Ytterby, Kungälvs kommun",105,91,196,4,1244,5100000
2022-09-27,Bergsvägen 28,"Ödsmålsmosse, Kungälvs kommun",58,7,65,3,1631,3075000
2022-09-24,Korpvägen 263,"Ullstorp, Kungälvs kommun",158,18,176,6,387,6500000
2022-09-22,Hemvägen 48,"Diseröd, Kungälvs kommun",130,65,195,5,696,3650000
2022-09-17,Stenåldersgatan 55,"Ytterby, Kungälvs kommun",120,15,135,5,395,5200000
2022-09-06,Barlinds väg 38,"Instön, Kungälvs kommun",98,2,100,4,1290,8500000
2022-09-01,Grepvägen 385,"Ullstorp, Kungälvs kommun",121,29,150,5,388,5710000
2022-08-31,Tvetgatan 143,"Tveten, Kungälvs kommun",93,32,125,5,186,4200000
2022-08-27,Torsby 270,"Kärna, Kungälvs kommun",161,174,335,8,1915,5735000
2022-08-26,Lerskärsvägen 52,"Tjuvkil, Kungälvs kommun",106,49,155,4,1385,5520000
2022-08-24,Korsgatan 3,"Marstrand, Kungälvs kommun",116,30,146,4,494,9200000
2022-08-21,Blekeliden 6,"Västra Gatan, Kungälvs kommun",161,47,208,5,629,7300000
2022-08-04,Guddeby 210,"Ytterby, Kungälvs kommun",120,120,240,7,3512,4600000
2022-07-20,Glöskär 875,"Kärna, Kungälvs kommun",110,5,115,5,1615,6775000
2022-07-18,Stora Risby 400,"Hålta, Kungälvs kommun",74,68,142,6,1078,4500000
2022-07-15,Hemmansgatan 7,"Ytterby, Kungälvs kommun",155,42,197,6,875,5100000
2022-07-15,Hemvägen 7,"Romelanda, Kungälvs kommun",105,33,138,5,437,3750000
2022-07-10,Torsby 250,"Kärna, Kungälvs kommun",170,60,230,7,1810,6525000
2022-07-05,Rondan 13,"Kungälv - Ödsmålsmosse, Kungälvs kommun",102,55,157,5,1380,4650000
2022-06-28,Bergsvägen 4,"Ödsmålsmosse, Kungälvs kommun",88,15,103,2,783,3995000
2022-06-27,Östra gatan 9,"Gamla Kungälv, Kungälvs kommun",325,81,406,10,852,10500000
2022-06-23,Dösebacka 110,"Romelanda, Kungälvs kommun",144,79,223,6,5634,5780000
2022-06-22,Lerskärsvägen 18,"Tjuvkil, Kungälvs kommun",65,65,130,5,1216,3995000
2017-08-24,Sköldgatan 9,"YTTERBY, Kungälvs kommun",136,28,164,4,490,5250000
2017-08-23,Klåverön 580,"Marstrand, Kungälvs kommun",90,30,120,5,21929,21000000
2017-08-23,Stora Risby 530,"Hålta, Kungälvs kommun",62,53,115,4,925,2900000
2017-08-22,Heavägen 21,"Lycke, Kungälvs kommun",140,40,180,5,2355,3775000
2017-08-18,Husfrejagatan 7,"Iskällan, Kungälvs kommun",124,151,275,8,984,7150000
2017-08-09,Bergsgatan 7,"Marstrand, Kungälvs kommun",265,67,332,7,729,10500000
2017-08-08,Smugglaregatan 14,"Marstrandsön, Kungälvs kommun",133,91,224,6,744,16000000
2017-08-04,Hallbjörtorp 370,"Kungälv - Kärna, Kungälvs kommun",30,30,60,2,1535,2425000
2017-07-25,Länsmansvägen 8,"Ytterby, Kungälvs kommun",124,124,248,4,1369,6250000
2017-07-18,Fontinvägen 20,"Kungälv - Centrum, Kungälvs kommun",220,50,270,5,1034,6100000
2017-07-17,Olsåker 110,"Kareby, Kungälvs kommun",139,60,199,8,16226,5200000
2017-07-12,Prejelvägen 102,"Ullstorp, Kungälvs kommun",122,6,128,5,304,4800000
2017-07-11,Ulvesund 427,"KUNGÄLV - Ulvesund, Kungälvs kommun",100,10,110,5,939,3850000
2017-07-11,Sävstigen 2,"Centralt, Kungälvs kommun",121,1,122,5,534,3800000
2017-07-07,Nedre Knaverstad 280,"Aröd, Kungälvs kommun",99,15,114,4,2105,3300000
2017-06-21,Djupuddsvägen 6,"Marstrand-Instön, Kungälvs kommun",120,88,208,5,2346,4800000
2017-06-16,Jakobsvägen 25,"Aröd, Kungälvs kommun",75,25,100,4,1454,4150000
2017-06-14,Häradsvägen 18,"Ytterby, Kungälvs kommun",128,10,138,5,342,4500000
2017-06-14,Hällristningsgatan 15,"YTTERBY, Kungälvs kommun",107,5,112,5,430,5185000
2017-06-09,Grindbacken 20,"Grinden, Kungälvs kommun",148,44,192,7,903,6075000
2017-06-08,Åsebyberg 925,"Kungälvs kommun, Kungälvs kommun",177,57,234,6,2837,4750000
2017-06-03,Lökebergsvägen 61,"Marstrand, Kungälvs kommun",140,50,190,6,22000,12000000
2017-06-02,Staby 760,"Kärna, Kungälvs kommun",210,90,300,10,6203,5500000
2017-06-02,Hallebäcksvägen 31,"Aröd/Timmervik, Kungälvs kommun",75,18,93,3,1470,2250000
2017-06-02,Klövergången 10,"KUNGÄLV, Kungälvs kommun",120,10,130,4,407,3700000
2017-06-01,Grindenvägen 27,"Grinden, Kungälvs kommun",165,65,230,7,925,5205000
2017-06-01,Duvesjön 465,"Romelanda-Duvesjön, Kungälvs kommun",36,4,40,2,1586,1150000
2017-05-28,Rishammar 250,"Kareby, Kungälvs kommun",104,90,194,6,1215,3750000
2021-10-20,Lundby 330,"Kungälv - Kareby, Kungälvs kommun",123,33,156,4,1870,4175000
2021-10-20,Tega 190,"Ytterby, Kungälvs kommun",223,129,352,9,1154,4500000
2021-10-19,Prästvägen 721,"Diseröd, Kungälvs kommun",210,60,270,7,1096,5900000
2021-10-14,Guntorpsvägen 12,"Kode, Kungälvs kommun",139,70,209,8,1039,4130000
2021-10-12,Vävra 470,"Hålta, Kungälvs kommun",160,10,170,5,3244,3750000
2021-10-06,Källeröd 140,"Kareby, Kungälvs kommun",103,143,246,7,1769,6000000
2021-10-06,Rishammarvägen 14,"Kareby, Kungälvs kommun",168,84,252,5,795,6500000
2021-10-01,Tyftervägen 30,"Diseröd, Kungälvs kommun",61,40,101,6,1683,2700000
2021-10-01,Västra Strandgatan 1,"Kungälv - Centrum, Kungälvs kommun",120,58,178,6,640,6175000
2021-09-30,Holmängen 150,"Kärna, Kungälvs kommun",117,60,177,4,1276,5400000
2021-09-25,Bokvägen 5,"Centrum, Kungälvs kommun",89,89,178,5,636,6800000
2021-09-21,Skårby 590,"Kareby, Kungälvs kommun",107,10,117,4,1132,4300000
2021-09-16,Målardalen 210,"Kode, Kungälvs kommun",130,26,156,9,3056,3325000
2021-09-16,Ingegatan 6R,"Komarken, Kungälvs kommun",149,71,220,7,152,5000000
2021-09-15,Halleravägen 17,"Kovikshamn, Kungälvs kommun",74,18,92,4,1215,5110000
2021-09-14,Skolstigen 4,"Kungälv - Centralt, Kungälvs kommun",174,74,248,7,763,6700000
2021-09-13,Toreby 390,"Harestad-Toreby, Kungälvs kommun",115,78,193,5,1819,4720000
2021-09-11,Skårby station 520,"Kareby, Kungälvs kommun",124,37,161,5,1060,4445000
2021-09-08,Kastellegårdsvägen 240,"Kastellegården, Kungälvs kommun",108,55,163,4,1391,4210000
2021-09-08,Kareby kyrkväg 320,"Bohuslän, Kungälvs kommun",110,80,190,5,1395,4725000
2021-09-06,Munkegärdegatan 231,"Munkegärde, Kungälvs kommun",155,40,195,6,726,6190000
2021-09-05,Betesgatan 14,"Ytterby, Kungälvs kommun",170,10,180,6,752,7475000
2021-09-02,Hermansby 150,"Kärna, Kungälvs kommun",110,110,220,6,2397,5600000
2021-09-01,Poppelvägen 3,"Diseröd, Kungälvs kommun",106,48,154,5,800,4600000
2021-08-30,Domsvägen 5,"Ytterby, Kungälvs kommun",95,45,140,6,1043,5775000
2021-08-25,Olserödsgatan 116,"Olseröd, Kungälvs kommun",150,34,184,5,725,6150000
2021-08-25,Lefstad 370,"Kärna, Kungälvs kommun",105,64,169,5,1759,6100000
2018-10-17,Ellesbovägen 204,"Kungälv, Kungälvs kommun",75,48,123,5,1062,3000000
2018-10-15,Olserödsgatan 106,"Olseröd, Kungälvs kommun",170,20,190,5,1227,6000000
2018-10-11,Åsebyberg 855,"Kode, Kungälvs kommun",129,18,147,5,4105,3850000
2018-10-04,Guntorpsvägen 24,"Kode, Kungälvs kommun",110,100,210,5,1065,2975000
2018-10-03,Lerlycke 250,"Kärna, Kungälvs kommun",130,88,218,5,1020,3700000
2018-10-02,Olvonvägen 23,"Diseröd, Kungälvs kommun",222,98,320,7,1000,3600000
2018-09-28,Bockebergsvägen 2,"Lycke, Kungälvs kommun",49,10,59,4,1386,1850000
2018-09-27,Lerskärsvägen 21,"Tjuvkil, Kungälvs kommun",120,40,160,4,1299,4700000
2018-09-27,Valtersäng 35,"Centralt, Kungälvs kommun",159,40,199,6,650,6120000
2018-09-25,Västra gatan 26A,"Centralt, Kungälvs kommun",149,21,170,6,316,5500000
2018-09-24,Gamla Kungälvsvägen 13,"Ytterby, Kungälvs kommun",176,87,263,8,1862,6800000
2018-09-13,Lerskärsvägen 50,"Lycke, Kungälvs kommun",93,93,186,5,1221,3750000
2018-09-11,Rubinvägen 6,"Kode, Kungälvs kommun",108,114,222,5,1123,3650000
2018-09-11,Bastubäcksvägen 11,"Ödsmåls mosse/Rörtången, Kungälvs kommun",78,15,93,3,1225,3100000
2018-09-10,Glose 110,"Glose, Kungälvs kommun",150,30,180,5,3157,4500000
2018-09-09,Bokvägen 3,"Kungälv centralt, Fontin., Kungälvs kommun",184,128,312,8,781,5350000
2018-09-04,Storskiftegatan 11,"Ytterby, Kungälvs kommun",90,40,130,4,188,3375000
2018-09-03,Vältvägen 505,"Bohuslän, Kungälvs kommun",121,9,130,5,250,4800000
2018-08-30,Hammarhöjden 695,"Kode, Kungälvs kommun",83,28,111,3,1053,2750000
2018-08-30,Kärnavägen 16,"Kärna, Kungälvs kommun",171,83,254,7,695,4120000
2018-08-30,Klintegatan 17,"Centralt - Kungälv, Kungälvs kommun",125,51,176,7,704,7350000
2018-08-29,Grepvägen 391,"Ullstorp, Kungälvs kommun",121,7,128,5,431,4850000
2018-08-25,Kristinedalsgatan 7,"Centrum, Kungälvs kommun",178,85,263,6,857,7125000
2018-08-24,Korpvägen 259,"KUNGÄLV, Kungälvs kommun",139,18,157,6,437,5500000
2018-08-09,Hammarhöjden 670,"Kode, Kungälvs kommun",100,47,147,2,1090,3230000
2018-07-18,Byvägen 18,"Ödsmåls mosse/Rörtången, Kungälvs kommun",60,42,102,4,1509,1850000
2018-07-17,Guntorpsvägen 2,"Kode, Kungälvs kommun",129,70,199,7,734,3150000
2018-07-12,Tjuvkil 510,"Tjuvkil, Kungälvs kommun",90,98,188,4,2575,2550000
2018-07-09,Gunneröd 200,"Lycke, Kungälvs kommun",58,25,83,2,789,2400000
2016-06-21,Alelyckans väg 23,"Kode, Kungälvs kommun",80,100,180,5,37080,9000000
2016-06-19,Krokens Väg 16,"Tjuvkil, Kungälvs kommun",67,50,117,4,1590,3250000
2016-06-14,Stenstavägen 1,"Tjuvkil, Kungälvs kommun",125,32,157,5,800,3850000
2016-06-14,Instölid 82,"MARSTRAND, Kungälvs kommun",36,10,46,3,902,2320000
2016-06-10,Rönnvägen 7,"Romelanda Diseröd, Kungälvs kommun",122,82,204,7,796,3300000
2016-06-08,Valler 300,"Valler - Romelanda, Kungälvs kommun",185,52,237,7,2497,3450000
2016-06-04,Fontinvägen 42,"Centrum, Kungälvs kommun",118,7,125,4,440,5100000
2016-06-03,Bokvägen 10,"Centrum, Kungälvs kommun",125,27,152,5,635,4400000
2016-06-02,Hermansby 150,"Kärna, Kungälvs kommun",123,97,220,6,2397,4070000
2016-06-01,Duvesjön 348,"Kungälv -Duvesjön, Kungälvs kommun",160,26,186,4,1927,5200000
2016-05-31,Åsgatan 5,"Kungälv - Centrum, Kungälvs kommun",120,60,180,6,948,5565000
2016-05-30,Olserödsgatan 114,"Kungälv - Olseröd, Kungälvs kommun",144,132,276,7,712,5325000
2016-05-27,Slånbärsvägen 15,"Munkegärde Östra, Kungälvs kommun",145,31,176,5,647,5100000
2016-05-26,Stinneröd 260,"Bohuslän, Kungälvs kommun",65,65,130,4,1734,1300000
2016-05-23,Mjölnarvägen 16,"Romelanda, Kungälvs kommun",121,47,168,5,831,2385000
2016-05-21,Lerskärsvägen 63,"Tjuvkil, Kungälvs kommun",110,10,120,3,884,3875000
2016-05-17,Jägarvägen 6,"Romelanda, Kungälvs kommun",159,16,175,6,564,3625000
2016-05-15,Brunnefjällsvägen 3,"Vedhall, Kungälvs kommun",94,16,110,4,1067,2695000
2016-05-14,Toreby 380,"Harestad, Kungälvs kommun",157,99,256,7,2591,2902500
2016-05-13,Hemvägen 25,"Romelanda - Diseröd, Kungälvs kommun",138,19,157,5,381,3250000
2016-05-12,Solskiftegatan 14,"Ytterby - Tega, Kungälvs kommun",171,25,196,6,1091,3900000
2016-05-09,Skårby Mosse 880,"Skårby, Kungälvs kommun",86,40,126,3,1782,2900000
2016-05-06,Ugglehed 180,"Önneröd, Kungälvs kommun",106,64,170,5,15352,2730000
2016-04-29,Duvesjön 201,"Duvesjön, Kungälvs kommun",38,9,47,2,1390,1300000
2016-04-28,Munkholmsgatan 2,"Centralt, Kungälvs kommun",137,73,210,7,893,4900000
2016-04-28,Björkstigen 9,"Romelanda, Kungälvs kommun",185,46,231,7,937,3700000
2016-04-25,Settungsvägen 62,"Ullstorp, Kungälvs kommun",140,26,166,6,372,4450000
2016-04-24,Situlagatan 2,"Ytterby, Kungälvs kommun",150,20,170,6,787,4500000
2016-04-14,Olvonvägen 71,"Kungälv - Romelanda, Kungälvs kommun",115,115,230,6,2056,4725000
2016-04-14,Rättarevägen 16,"Ytterby, Kungälvs kommun",105,122,227,6,732,4300000
